n_urns,Bn,Un,Ln,Cn,Dn,Dn-Cn
1000,102,364,6,8577,10770,2193
1000,33,372,5,8056,11179,3123
1000,53,356,6,6943,9289,2346
1000,26,371,5,8674,9505,831
1000,22,362,5,5924,10969,5045
1000,18,376,6,8761,8878,117
1000,20,357,5,7409,10833,3424
1000,43,372,6,7005,11910,4905
1000,33,381,5,6505,10499,3994
1000,85,374,5,7150,9382,2232
1000,22,362,5,7227,11369,4142
1000,44,384,5,8156,10855,2699
1000,63,369,5,8128,10344,2216
1000,20,378,6,7611,9485,1874
1000,37,359,6,7012,8139,1127
1000,32,376,6,7583,10069,2486
1000,64,347,6,7939,10035,2096
1000,45,363,5,8846,9555,709
1000,42,373,6,6720,10882,4162
1000,23,362,5,5391,7681,2290
1000,73,366,5,6437,9858,3421
1000,21,368,5,6845,7933,1088
1000,66,370,5,7676,8260,584
1000,24,358,5,7766,8972,1206
1000,28,387,6,9216,9924,708
1000,31,356,5,6905,8506,1601
1000,12,371,5,6532,8858,2326
1000,34,360,5,8527,11068,2541
1000,50,364,6,7626,9946,2320
1000,26,376,5,10322,12143,1821
1000,40,383,5,8751,9425,674
1000,47,367,7,10980,11264,284
1000,74,383,6,6972,10188,3216
1000,29,365,5,7129,9908,2779
1000,83,354,7,7936,8407,471
1000,63,354,6,6431,9414,2983
1000,61,364,7,8516,10535,2019
1000,21,377,6,7318,9662,2344
1000,21,382,5,6573,9203,2630
1000,20,359,4,8526,8901,375
1000,31,373,5,6430,13390,6960
1000,26,358,6,6674,8816,2142
1000,36,349,6,5400,7943,2543
1000,46,346,6,8034,9905,1871
1000,48,360,5,7122,9207,2085
1000,29,373,6,8313,9343,1030
1000,19,376,6,6023,7496,1473
1000,35,373,6,6641,9717,3076
1000,18,362,5,10975,11657,682
1000,24,390,6,7984,9248,1264
2000,98,726,6,12898,23123,10225
2000,81,732,8,16252,22515,6263
2000,80,727,7,17518,25481,7963
2000,60,732,5,18611,29227,10616
2000,61,736,6,13488,17752,4264
2000,137,742,5,15114,16668,1554
2000,43,750,7,14313,19779,5466
2000,46,721,6,26240,27084,844
2000,20,764,5,19698,20862,1164
2000,59,769,6,13890,22436,8546
2000,41,735,7,16009,18052,2043
2000,77,735,6,19227,20292,1065
2000,52,765,6,18033,19466,1433
2000,47,707,7,17144,21049,3905
2000,43,726,6,15381,18423,3042
2000,19,764,5,15309,20129,4820
2000,19,740,6,17907,22958,5051
2000,60,751,5,20633,20763,130
2000,26,731,6,16454,22552,6098
2000,33,747,5,14436,20253,5817
2000,37,742,7,17469,18247,778
2000,83,734,6,12818,18196,5378
2000,73,738,5,16132,18258,2126
2000,69,727,6,15285,19584,4299
2000,59,733,6,15170,18048,2878
2000,22,752,6,15884,22330,6446
2000,39,730,6,13839,22828,8989
2000,105,760,6,16861,23734,6873
2000,79,746,7,17236,18022,786
2000,72,716,5,24105,29869,5764
2000,119,733,5,20988,23296,2308
2000,29,727,6,16174,19341,3167
2000,34,724,6,11105,22009,10904
2000,57,748,6,15081,22056,6975
2000,64,744,6,15930,23021,7091
2000,103,755,5,22520,25886,3366
2000,54,748,8,13372,19697,6325
2000,50,738,7,25850,27480,1630
2000,29,740,6,16869,20101,3232
2000,33,771,6,17549,24215,6666
2000,63,758,5,15994,17848,1854
2000,76,759,6,17615,19410,1795
2000,71,717,6,18262,21958,3696
2000,40,731,6,17076,21884,4808
2000,29,748,6,15624,19916,4292
2000,35,730,5,12424,20096,7672
2000,22,731,5,18047,20777,2730
2000,48,732,5,13523,20542,7019
2000,53,739,6,19287,20796,1509
2000,42,726,6,13823,21174,7351
3000,41,1102,6,22742,26914,4172
3000,48,1129,6,25316,30212,4896
3000,70,1102,7,31718,32802,1084
3000,18,1118,6,25439,39049,13610
3000,47,1109,6,23405,48319,24914
3000,170,1081,6,27260,34656,7396
3000,113,1102,7,22692,30237,7545
3000,17,1110,6,24343,37469,13126
3000,80,1120,6,25292,28957,3665
3000,90,1076,6,24147,30987,6840
3000,80,1166,6,22807,26807,4000
3000,54,1091,6,23799,27881,4082
3000,124,1108,5,27061,33575,6514
3000,69,1107,6,20383,46274,25891
3000,70,1093,6,21003,31723,10720
3000,41,1119,6,26358,29458,3100
3000,13,1125,7,24300,32760,8460
3000,29,1082,6,23785,30702,6917
3000,127,1117,7,37181,39927,2746
3000,53,1094,6,22750,33956,11206
3000,25,1124,7,25031,35292,10261
3000,49,1110,6,20152,32122,11970
3000,31,1118,6,26151,31973,5822
3000,100,1092,6,24117,40580,16463
3000,56,1101,6,24160,30144,5984
3000,90,1100,6,27965,35466,7501
3000,83,1103,6,26825,31039,4214
3000,82,1121,5,31776,35305,3529
3000,69,1108,5,27031,35199,8168
3000,97,1062,6,23567,34363,10796
3000,17,1105,7,28838,33259,4421
3000,105,1098,6,23433,35169,11736
3000,93,1105,7,28406,34978,6572
3000,49,1094,6,29743,34418,4675
3000,57,1085,5,19256,29658,10402
3000,80,1102,5,25779,29743,3964
3000,9,1118,5,25138,34066,8928
3000,74,1109,5,20449,28854,8405
3000,104,1121,7,27119,43094,15975
3000,80,1102,6,29159,31929,2770
3000,38,1106,7,27713,28979,1266
3000,72,1120,6,25225,34536,9311
3000,107,1100,6,35939,38212,2273
3000,47,1105,6,29101,31053,1952
3000,55,1130,8,25800,30839,5039
3000,111,1105,6,29269,36615,7346
3000,49,1084,6,26508,32298,5790
3000,84,1086,5,27925,29691,1766
3000,132,1071,5,22388,31939,9551
3000,101,1092,6,26220,29660,3440
4000,86,1468,6,33192,45366,12174
4000,128,1484,6,29450,45912,16462
4000,180,1466,7,29495,44051,14556
4000,33,1478,6,40120,43952,3832
4000,48,1490,6,34297,41301,7004
4000,113,1477,5,32650,43663,11013
4000,178,1508,8,29826,36779,6953
4000,20,1458,6,29391,43055,13664
4000,23,1474,6,36313,46880,10567
4000,29,1449,7,34425,37201,2776
4000,32,1469,6,33528,54976,21448
4000,57,1487,6,32371,41918,9547
4000,75,1462,6,31141,49538,18397
4000,10,1468,6,45122,47081,1959
4000,66,1470,6,40722,48213,7491
4000,100,1479,6,37452,56412,18960
4000,118,1456,7,34073,42291,8218
4000,41,1470,6,37898,40875,2977
4000,69,1470,6,33430,47871,14441
4000,160,1443,6,31264,48163,16899
4000,86,1447,6,39178,49006,9828
4000,42,1467,5,43452,43848,396
4000,81,1515,6,26587,45299,18712
4000,44,1442,6,43086,52766,9680
4000,91,1429,7,33574,53056,19482
4000,132,1445,6,37271,43131,5860
4000,40,1456,5,31062,51888,20826
4000,151,1426,6,29113,46146,17033
4000,40,1478,6,34585,43948,9363
4000,68,1470,6,37073,44051,6978
4000,67,1472,8,37946,42423,4477
4000,111,1477,5,35808,54978,19170
4000,48,1483,7,31566,39432,7866
4000,105,1466,6,32370,41669,9299
4000,26,1448,6,33289,40214,6925
4000,59,1495,6,33323,38642,5319
4000,118,1441,5,39404,43402,3998
4000,115,1487,6,53359,53434,75
4000,109,1467,8,41167,44215,3048
4000,6,1476,6,27491,41451,13960
4000,77,1502,7,36809,47044,10235
4000,123,1450,6,33035,44961,11926
4000,118,1463,6,47254,53865,6611
4000,53,1490,6,42736,44274,1538
4000,57,1491,6,32216,44429,12213
4000,190,1485,6,32740,50499,17759
4000,43,1447,6,28596,46858,18262
4000,88,1467,7,42217,43296,1079
4000,97,1462,6,30823,50310,19487
4000,59,1457,6,31646,45485,13839
5000,33,1872,6,40245,49181,8936
5000,79,1811,6,42847,54597,11750
5000,13,1844,6,43713,71300,27587
5000,72,1849,6,42502,54541,12039
5000,87,1873,7,44821,52881,8060
5000,214,1807,6,42915,56683,13768
5000,56,1876,6,37243,51512,14269
5000,114,1813,6,33574,61867,28293
5000,159,1854,6,40892,56785,15893
5000,111,1840,6,50086,59375,9289
5000,35,1820,7,48880,65021,16141
5000,75,1874,6,54993,60046,5053
5000,173,1829,6,53365,65827,12462
5000,131,1845,6,50763,59895,9132
5000,88,1851,6,33511,60788,27277
5000,139,1881,6,50980,61533,10553
5000,86,1824,8,58787,68145,9358
5000,80,1861,7,54268,63254,8986
5000,200,1857,6,37178,62847,25669
5000,104,1845,7,39918,54876,14958
5000,70,1850,6,46926,47889,963
5000,113,1830,7,48425,57020,8595
5000,143,1845,6,40469,64142,23673
5000,78,1834,7,41159,48809,7650
5000,99,1845,7,42551,58352,15801
5000,53,1857,7,61638,67671,6033
5000,213,1861,6,45611,55179,9568
5000,80,1851,7,43511,57122,13611
5000,81,1849,7,42851,73456,30605
5000,73,1843,8,42005,52673,10668
5000,130,1824,7,46002,56268,10266
5000,151,1824,7,49831,59499,9668
5000,30,1860,6,40282,54814,14532
5000,153,1857,6,38558,65152,26594
5000,109,1834,6,36663,54902,18239
5000,61,1864,6,43004,52772,9768
5000,68,1844,5,50666,59510,8844
5000,160,1819,7,43886,52327,8441
5000,49,1876,7,39077,60334,21257
5000,92,1880,8,35778,65494,29716
5000,97,1824,6,47702,56166,8464
5000,48,1874,6,40978,52762,11784
5000,155,1809,7,39777,55619,15842
5000,88,1851,6,48612,55506,6894
5000,68,1829,7,44876,52625,7749
5000,79,1895,6,38133,55630,17497
5000,181,1865,6,46095,55151,9056
5000,142,1840,6,51110,63636,12526
5000,179,1810,6,44806,57351,12545
5000,42,1827,6,44126,54021,9895
6000,15,2194,6,56152,65467,9315
6000,162,2171,7,48365,63042,14677
6000,124,2214,6,53152,62737,9585
6000,92,2208,7,54714,76023,21309
6000,146,2229,7,59713,72424,12711
6000,190,2198,7,50652,77082,26430
6000,37,2251,6,56805,62493,5688
6000,15,2227,8,58650,69983,11333
6000,96,2203,6,56996,72344,15348
6000,193,2221,7,56572,72196,15624
6000,174,2206,6,73189,78423,5234
6000,65,2227,6,65950,74178,8228
6000,6,2186,6,47389,66816,19427
6000,115,2211,7,46502,73034,26532
6000,58,2206,7,60935,68421,7486
6000,136,2198,7,63396,64192,796
6000,92,2211,6,49724,66710,16986
6000,34,2192,7,50027,71928,21901
6000,150,2212,6,53174,62278,9104
6000,86,2189,7,57443,64392,6949
6000,149,2192,8,48503,69634,21131
6000,90,2234,6,60166,67141,6975
6000,86,2184,7,58437,70301,11864
6000,88,2223,7,47472,73753,26281
6000,66,2196,5,43949,69076,25127
6000,19,2240,6,54928,70901,15973
6000,95,2199,8,60432,96164,35732
6000,68,2176,6,55319,61407,6088
6000,118,2185,7,54598,59812,5214
6000,175,2203,6,44071,56694,12623
6000,63,2184,7,64186,74399,10213
6000,148,2182,6,55173,65458,10285
6000,92,2181,6,48111,58347,10236
6000,173,2165,7,57242,69370,12128
6000,88,2211,6,51634,65462,13828
6000,199,2221,7,60286,64394,4108
6000,61,2201,7,52559,58619,6060
6000,51,2190,6,56069,74011,17942
6000,80,2212,6,58645,67072,8427
6000,152,2161,6,54790,66012,11222
6000,57,2218,8,48775,73551,24776
6000,108,2232,7,58341,65597,7256
6000,109,2179,6,61093,68590,7497
6000,80,2203,6,53113,66800,13687
6000,95,2216,7,50550,66077,15527
6000,96,2210,6,51242,66602,15360
6000,35,2205,6,53390,70144,16754
6000,89,2193,7,48442,72118,23676
6000,154,2186,6,51594,59386,7792
6000,10,2229,7,51772,70577,18805
7000,220,2551,7,52102,72390,20288
7000,117,2579,6,71097,76525,5428
7000,92,2580,6,66252,100882,34630
7000,113,2564,5,55852,87805,31953
7000,139,2624,6,74266,76726,2460
7000,99,2580,6,78435,87059,8624
7000,197,2616,6,64676,84469,19793
7000,93,2600,7,66532,72329,5797
7000,111,2604,6,64297,92294,27997
7000,74,2583,7,59180,71365,12185
7000,129,2526,6,61183,90547,29364
7000,83,2551,8,57788,84821,27033
7000,112,2513,7,64183,76457,12274
7000,103,2556,7,58575,83319,24744
7000,64,2575,6,61100,79750,18650
7000,196,2580,6,63882,80022,16140
7000,150,2657,6,66026,78621,12595
7000,171,2574,6,63708,100531,36823
7000,177,2557,8,56815,74458,17643
7000,77,2548,6,71002,81735,10733
7000,112,2592,7,84133,87443,3310
7000,195,2532,6,61310,73373,12063
7000,197,2544,6,61974,80638,18664
7000,85,2569,6,65509,77966,12457
7000,79,2590,8,56676,88653,31977
7000,110,2601,6,69628,81700,12072
7000,80,2574,6,70410,80582,10172
7000,52,2583,7,55903,70771,14868
7000,27,2563,6,57192,89121,31929
7000,94,2551,7,69920,79919,9999
7000,123,2551,6,67330,78303,10973
7000,79,2587,6,64053,96514,32461
7000,58,2606,10,60073,75590,15517
7000,58,2572,6,62784,75430,12646
7000,33,2569,7,64758,79797,15039
7000,101,2587,7,54823,76212,21389
7000,117,2552,6,66964,102882,35918
7000,85,2553,6,66251,99958,33707
7000,189,2569,5,59690,126212,66522
7000,100,2574,6,61216,65506,4290
7000,149,2584,7,71404,91945,20541
7000,142,2558,6,61230,93097,31867
7000,148,2546,6,57618,70073,12455
7000,157,2591,6,63916,71646,7730
7000,142,2573,6,60159,82228,22069
7000,20,2546,7,59904,70169,10265
7000,184,2584,7,70245,80701,10456
7000,161,2578,7,56035,87269,31234
7000,100,2546,7,51654,69536,17882
7000,44,2565,6,61178,74653,13475
8000,135,2912,6,102387,114260,11873
8000,24,2904,6,76493,105083,28590
8000,95,2911,6,92159,106257,14098
8000,110,2965,6,66550,96174,29624
8000,106,2933,7,72674,80420,7746
8000,91,2914,7,77188,85979,8791
8000,94,2903,6,82152,97069,14917
8000,70,2925,7,87648,100448,12800
8000,42,2952,6,87137,106300,19163
8000,127,2910,6,70443,96273,25830
8000,41,2966,6,73809,88602,14793
8000,117,2979,8,67365,118669,51304
8000,31,3000,6,70758,102281,31523
8000,10,2947,7,71329,96031,24702
8000,197,2868,6,69577,80296,10719
8000,48,2926,7,77855,88184,10329
8000,167,2918,6,80231,83761,3530
8000,112,2971,7,73993,101600,27607
8000,62,2949,6,77454,95398,17944
8000,132,2918,6,64512,92894,28382
8000,53,2932,6,77136,99321,22185
8000,177,2955,7,86399,94424,8025
8000,57,2953,6,62065,108531,46466
8000,21,2923,7,68799,102731,33932
8000,113,2935,6,69038,103378,34340
8000,207,2975,6,75032,105334,30302
8000,190,2954,7,78136,84718,6582
8000,78,2934,6,63986,94398,30412
8000,87,2919,6,74460,105972,31512
8000,139,2900,6,77319,107149,29830
8000,51,2923,7,65922,88253,22331
8000,113,2935,7,71314,91273,19959
8000,158,2936,6,74620,89300,14680
8000,36,2941,6,112073,112704,631
8000,73,2935,7,76128,86619,10491
8000,114,2995,7,66031,86321,20290
8000,91,2926,7,79778,103355,23577
8000,64,2978,6,83279,114489,31210
8000,156,2961,7,71973,105447,33474
8000,79,2914,6,97013,98443,1430
8000,70,2973,8,71105,121683,50578
8000,167,2947,6,73718,91338,17620
8000,109,2941,6,102581,104995,2414
8000,178,2967,6,72311,104896,32585
8000,123,2951,7,70985,90677,19692
8000,173,2948,7,75984,87784,11800
8000,156,2986,7,90991,96212,5221
8000,209,2895,6,62857,91700,28843
8000,79,2955,7,73736,101617,27881
8000,59,2968,6,101284,113813,12529
9000,150,3348,8,92907,101447,8540
9000,198,3306,8,97741,113951,16210
9000,63,3268,7,86331,106416,20085
9000,197,3305,7,89610,107619,18009
9000,141,3315,6,76576,102795,26219
9000,181,3287,6,72319,116869,44550
9000,181,3309,7,95898,102144,6246
9000,109,3322,8,78590,87823,9233
9000,37,3314,8,94350,128081,33731
9000,100,3285,6,98836,109570,10734
9000,69,3333,7,93284,108678,15394
9000,142,3301,6,79468,108558,29090
9000,121,3376,7,90963,103231,12268
9000,90,3342,6,86362,88456,2094
9000,113,3297,6,93264,99971,6707
9000,114,3357,7,81654,126309,44655
9000,141,3335,6,76789,96833,20044
9000,131,3295,7,98513,101347,2834
9000,132,3287,6,71281,105196,33915
9000,164,3268,7,70992,101675,30683
9000,220,3302,6,75105,100199,25094
9000,114,3349,6,79260,117986,38726
9000,85,3322,6,72538,113572,41034
9000,207,3280,8,80902,126441,45539
9000,201,3324,8,82174,125004,42830
9000,156,3287,6,79490,103585,24095
9000,86,3360,7,92359,108225,15866
9000,206,3296,6,76254,101416,25162
9000,271,3292,6,79289,116713,37424
9000,108,3278,6,93513,108443,14930
9000,17,3281,6,70918,125355,54437
9000,141,3295,7,75827,102819,26992
9000,234,3351,6,85669,101977,16308
9000,197,3263,7,100091,106038,5947
9000,132,3321,7,85358,106511,21153
9000,152,3297,7,78940,131801,52861
9000,37,3366,7,76581,99549,22968
9000,158,3285,7,73720,97994,24274
9000,152,3296,6,71024,96087,25063
9000,79,3311,6,87950,91299,3349
9000,146,3360,7,93070,123024,29954
9000,80,3308,6,83977,110541,26564
9000,154,3261,6,85167,96365,11198
9000,131,3306,6,88542,109721,21179
9000,97,3287,7,75944,101037,25093
9000,131,3307,7,89069,107657,18588
9000,158,3308,7,91834,98695,6861
9000,156,3308,6,106364,107782,1418
9000,135,3325,7,83296,97389,14093
9000,181,3293,6,75881,97351,21470
10000,244,3679,7,98754,120074,21320
10000,38,3690,6,95750,120433,24683
10000,109,3667,7,100124,107727,7603
10000,164,3676,7,86376,111978,25602
10000,139,3662,7,87455,118818,31363
10000,128,3657,6,104487,116684,12197
10000,58,3716,10,95316,113921,18605
10000,169,3675,8,100970,109554,8584
10000,29,3632,7,86200,113266,27066
10000,61,3706,7,107884,120797,12913
10000,39,3647,6,125223,128749,3526
10000,96,3694,6,96295,126754,30459
10000,106,3664,7,98606,128175,29569
10000,111,3678,7,88676,116778,28102
10000,85,3640,7,96336,116113,19777
10000,196,3714,7,91736,118669,26933
10000,101,3693,7,95680,140163,44483
10000,64,3667,7,92434,140948,48514
10000,97,3694,6,86336,98861,12525
10000,32,3675,8,96076,119146,23070
10000,131,3688,6,107930,131154,23224
10000,78,3659,7,98887,114410,15523
10000,40,3706,6,104289,118646,14357
10000,62,3650,6,102799,126352,23553
10000,267,3639,6,96146,105962,9816
10000,118,3697,7,93337,118069,24732
10000,107,3659,6,91507,116331,24824
10000,135,3662,7,87338,130140,42802
10000,42,3739,6,88208,132181,43973
10000,109,3644,6,113769,182854,69085
10000,96,3744,8,93009,125541,32532
10000,80,3665,6,78073,113169,35096
10000,179,3725,9,99375,126669,27294
10000,254,3703,7,106504,138043,31539
10000,153,3621,7,120546,129069,8523
10000,140,3691,7,87239,133777,46538
10000,209,3644,6,91937,116885,24948
10000,126,3675,6,112272,155076,42804
10000,197,3681,6,84674,104218,19544
10000,82,3641,6,119327,153291,33964
10000,20,3670,8,89392,143625,54233
10000,159,3671,6,107996,118816,10820
10000,66,3691,7,112632,127801,15169
10000,83,3703,7,92161,113628,21467
10000,49,3694,7,105914,117108,11194
10000,125,3717,6,113194,128244,15050
10000,63,3686,6,81688,125852,44164
10000,85,3680,7,114171,114538,367
10000,230,3649,6,84860,110713,25853
10000,97,3672,6,107129,109731,2602
11000,100,4036,6,85166,128326,43160
11000,81,3995,7,116251,124044,7793
11000,176,4065,7,117890,128403,10513
11000,215,4136,7,95914,143534,47620
11000,170,4047,7,112079,149912,37833
11000,256,4065,6,97638,132482,34844
11000,45,3998,7,106468,130226,23758
11000,176,3989,8,113544,148470,34926
11000,94,4031,8,114790,123514,8724
11000,255,4040,6,113306,142383,29077
11000,68,4109,9,98721,112140,13419
11000,101,4093,7,90069,118381,28312
11000,174,4042,6,96264,119683,23419
11000,79,4064,6,110558,141931,31373
11000,108,4062,7,92000,133012,41012
11000,197,3996,7,96559,160764,64205
11000,110,4037,7,112020,147949,35929
11000,111,4107,8,118767,134996,16229
11000,27,4045,6,107929,201484,93555
11000,57,4110,7,102836,134764,31928
11000,103,4075,7,111166,122136,10970
11000,156,4008,7,145053,193236,48183
11000,132,3973,6,115103,133583,18480
11000,271,4001,7,107734,128727,20993
11000,52,3987,6,112368,129702,17334
11000,196,4007,6,102697,124522,21825
11000,26,3983,6,91031,118405,27374
11000,107,4028,7,113122,119999,6877
11000,37,4035,6,102078,138450,36372
11000,85,4052,6,102293,124338,22045
11000,109,4014,6,99323,124050,24727
11000,197,4089,6,101358,130885,29527
11000,164,3991,6,98742,142571,43829
11000,127,4084,6,88238,136036,47798
11000,235,3980,6,121288,124235,2947
11000,199,4063,6,89179,135818,46639
11000,81,4043,6,120445,144856,24411
11000,117,4055,8,113095,119292,6197
11000,167,4077,7,94261,129793,35532
11000,57,4050,7,97074,128673,31599
11000,89,4060,7,142865,144566,1701
11000,90,4028,7,101281,126244,24963
11000,200,4070,7,90394,119795,29401
11000,93,4082,7,117770,120152,2382
11000,137,4045,6,98908,152178,53270
11000,16,4093,6,99520,116526,17006
11000,186,4018,6,117568,140339,22771
11000,250,4039,6,111671,159522,47851
11000,223,4079,6,127562,154400,26838
11000,29,4022,7,104247,177443,73196
12000,132,4405,7,109353,175648,66295
12000,102,4305,6,133742,140092,6350
12000,237,4424,7,119149,146289,27140
12000,214,4438,7,101415,146455,45040
12000,137,4413,7,109432,139850,30418
12000,251,4457,6,126928,145575,18647
12000,67,4433,7,118907,140965,22058
12000,204,4422,6,161351,162947,1596
12000,197,4394,8,104523,172579,68056
12000,117,4443,8,129079,143654,14575
12000,43,4429,7,142580,184519,41939
12000,40,4379,7,154910,177329,22419
12000,134,4419,6,121119,155389,34270
12000,78,4410,6,124031,160725,36694
12000,102,4438,6,127408,151641,24233
12000,131,4461,6,118421,144023,25602
12000,184,4387,7,102537,126261,23724
12000,82,4416,7,116040,143940,27900
12000,122,4388,7,110307,141808,31501
12000,114,4399,6,100329,133032,32703
12000,285,4389,7,106411,164918,58507
12000,131,4410,7,114913,137751,22838
12000,126,4458,7,108033,175820,67787
12000,53,4376,6,97262,157997,60735
12000,90,4421,8,113195,151434,38239
12000,17,4423,7,104480,144303,39823
12000,92,4450,6,112548,125176,12628
12000,104,4341,6,111999,132987,20988
12000,71,4415,7,94407,132718,38311
12000,153,4394,7,166724,187469,20745
12000,56,4373,6,130129,149194,19065
12000,158,4423,6,135490,139978,4488
12000,115,4423,6,127070,155946,28876
12000,145,4393,7,99716,151748,52032
12000,179,4420,7,110951,132314,21363
12000,78,4400,7,104202,158156,53954
12000,97,4401,8,116372,166102,49730
12000,116,4428,7,111434,141907,30473
12000,42,4519,7,104086,153988,49902
12000,93,4468,6,153782,157699,3917
12000,166,4486,8,109497,154610,45113
12000,236,4400,6,140174,181840,41666
12000,214,4454,7,120492,155452,34960
12000,174,4485,7,127049,141319,14270
12000,147,4441,6,131915,152683,20768
12000,160,4456,7,118901,192708,73807
12000,21,4355,6,137886,197012,59126
12000,238,4389,8,118572,149366,30794
12000,101,4442,7,118616,164364,45748
12000,29,4440,6,112732,132768,20036
13000,103,4792,7,129154,160610,31456
13000,216,4793,6,115887,177014,61127
13000,246,4753,7,119783,178824,59041
13000,54,4780,7,104021,162747,58726
13000,121,4774,7,126761,199708,72947
13000,239,4763,6,135907,152828,16921
13000,214,4779,6,142636,198990,56354
13000,74,4791,6,135501,205300,69799
13000,94,4739,7,142884,165633,22749
13000,94,4748,6,109869,145498,35629
13000,133,4760,6,130845,153730,22885
13000,147,4788,7,132089,153562,21473
13000,175,4792,7,117223,164740,47517
13000,181,4835,8,121006,191873,70867
13000,106,4793,7,126393,154956,28563
13000,79,4740,7,138071,162551,24480
13000,93,4814,6,139669,166254,26585
13000,230,4855,8,122236,144098,21862
13000,240,4788,7,131410,149253,17843
13000,186,4756,7,113364,159207,45843
13000,232,4787,6,119235,162013,42778
13000,174,4758,8,136501,160026,23525
13000,142,4816,7,138924,164526,25602
13000,262,4771,6,130366,150947,20581
13000,92,4764,8,124905,154847,29942
13000,104,4775,7,125781,154618,28837
13000,252,4753,7,134008,165285,31277
13000,106,4768,8,116395,174355,57960
13000,108,4802,8,155544,199112,43568
13000,127,4822,6,106623,150778,44155
13000,80,4800,6,159865,169909,10044
13000,261,4794,7,127184,171153,43969
13000,118,4779,7,125495,142925,17430
13000,95,4794,7,148187,154674,6487
13000,251,4710,7,118413,173150,54737
13000,183,4740,7,120065,160109,40044
13000,141,4815,6,137057,154004,16947
13000,109,4801,7,114964,174665,59701
13000,122,4770,7,146814,160733,13919
13000,58,4799,6,148875,169847,20972
13000,124,4818,7,141078,199556,58478
13000,109,4808,6,114485,152101,37616
13000,231,4822,7,156699,168658,11959
13000,161,4790,7,142444,153396,10952
13000,62,4813,7,163311,187512,24201
13000,132,4737,7,162278,173831,11553
13000,43,4852,6,136013,180218,44205
13000,137,4772,7,123434,166947,43513
13000,127,4685,7,149966,174096,24130
13000,177,4810,7,116863,178618,61755
14000,195,5080,6,129585,170085,40500
14000,62,5151,7,131765,173343,41578
14000,245,5180,7,132574,177376,44802
14000,139,5172,7,157800,177295,19495
14000,131,5175,6,131657,170736,39079
14000,182,5186,7,133480,161241,27761
14000,226,5163,6,146823,180589,33766
14000,31,5142,6,126233,171795,45562
14000,237,5150,7,116381,193924,77543
14000,68,5110,9,128135,147387,19252
14000,243,5157,9,169553,184262,14709
14000,280,5167,7,196961,215831,18870
14000,213,5135,8,125314,194219,68905
14000,33,5170,6,149519,183321,33802
14000,275,5155,7,185812,191711,5899
14000,154,5222,7,169085,201823,32738
14000,47,5140,6,152955,220991,68036
14000,259,5119,7,122125,178401,56276
14000,96,5176,7,130333,179481,49148
14000,222,5154,7,145319,184004,38685
14000,34,5192,7,134096,186224,52128
14000,133,5176,7,128780,189464,60684
14000,77,5147,7,125117,160901,35784
14000,61,5176,7,132213,193462,61249
14000,190,5130,6,135831,191161,55330
14000,236,5086,6,138921,192621,53700
14000,113,5188,7,149820,203524,53704
14000,126,5194,6,118016,171710,53694
14000,161,5124,7,131634,176279,44645
14000,232,5161,7,137331,171105,33774
14000,135,5128,6,144847,168838,23991
14000,65,5137,7,139613,169116,29503
14000,189,5114,7,138011,170686,32675
14000,77,5130,7,118799,179287,60488
14000,274,5127,6,171470,178017,6547
14000,25,5223,7,161562,192638,31076
14000,149,5173,7,135284,164880,29596
14000,172,5136,6,135597,185617,50020
14000,68,5190,6,139232,197253,58021
14000,158,5194,7,123031,189607,66576
14000,59,5158,7,145668,173315,27647
14000,71,5142,7,141115,155717,14602
14000,178,5113,6,160126,168318,8192
14000,51,5182,8,128521,182149,53628
14000,187,5180,6,144359,170997,26638
14000,48,5129,7,138829,169769,30940
14000,163,5170,7,156433,228596,72163
14000,180,5143,7,166178,174560,8382
14000,139,5121,6,124632,164988,40356
14000,137,5157,7,112781,174050,61269
15000,165,5501,8,151430,206155,54725
15000,118,5536,6,157222,185619,28397
15000,299,5565,7,152330,164953,12623
15000,103,5539,7,158917,197399,38482
15000,149,5543,6,130421,163249,32828
15000,213,5470,7,147146,169334,22188
15000,194,5450,6,148375,188064,39689
15000,135,5498,6,164572,188458,23886
15000,264,5472,6,197115,198362,1247
15000,79,5484,7,166059,204471,38412
15000,193,5462,7,134778,237572,102794
15000,160,5560,7,143117,182074,38957
15000,107,5556,7,152034,186966,34932
15000,208,5476,9,136372,198604,62232
15000,110,5450,7,158807,160459,1652
15000,102,5494,8,142497,172622,30125
15000,176,5516,6,163546,168850,5304
15000,246,5497,6,165977,176578,10601
15000,167,5539,7,144995,220264,75269
15000,56,5465,7,204725,216864,12139
15000,108,5548,6,135133,181512,46379
15000,36,5515,8,146493,158292,11799
15000,210,5452,8,147182,205954,58772
15000,55,5521,8,200155,200568,413
15000,14,5464,6,150156,171455,21299
15000,289,5476,6,142139,171358,29219
15000,306,5529,7,156030,207431,51401
15000,146,5486,7,121041,170588,49547
15000,229,5530,7,160502,223314,62812
15000,135,5487,6,162854,237088,74234
15000,216,5505,7,134398,177213,42815
15000,198,5442,7,175595,177567,1972
15000,209,5596,7,145232,229645,84413
15000,121,5571,6,128445,191526,63081
15000,102,5590,6,166948,198953,32005
15000,236,5515,6,151648,186264,34616
15000,158,5467,6,160660,171496,10836
15000,207,5515,6,118614,170941,52327
15000,117,5502,7,161295,212171,50876
15000,123,5480,6,155471,200394,44923
15000,156,5550,7,160928,181043,20115
15000,192,5495,7,132172,203183,71011
15000,180,5563,6,152607,179064,26457
15000,174,5503,7,135205,194606,59401
15000,141,5514,6,166395,187158,20763
15000,304,5488,6,130221,177786,47565
15000,376,5454,7,159883,183771,23888
15000,63,5563,7,132228,206355,74127
15000,259,5549,7,156091,195889,39798
15000,112,5441,6,133752,190679,56927
16000,272,5852,8,171486,184965,13479
16000,212,5850,8,133855,186797,52942
16000,164,5877,7,132499,177426,44927
16000,81,5897,7,136756,251314,114558
16000,71,5904,7,205951,215880,9929
16000,97,5897,7,148537,195484,46947
16000,197,5889,7,157652,299458,141806
16000,144,5862,6,144195,246318,102123
16000,70,5880,7,134047,175059,41012
16000,39,5895,7,170377,255509,85132
16000,213,5788,6,223368,264261,40893
16000,190,5894,6,218031,244850,26819
16000,215,5929,6,181499,279440,97941
16000,75,5885,7,184825,198311,13486
16000,220,5887,7,188297,288686,100389
16000,43,5873,7,162661,196584,33923
16000,100,5895,7,176258,268978,92720
16000,84,5928,6,195599,242200,46601
16000,200,5894,8,203387,273815,70428
16000,156,5934,7,228718,234699,5981
16000,192,5910,8,150937,209620,58683
16000,242,5859,8,176591,236991,60400
16000,335,5909,7,202932,216572,13640
16000,168,5875,7,143434,196298,52864
16000,263,5846,7,144853,236054,91201
16000,159,5922,7,192436,195822,3386
16000,48,5876,7,167259,197972,30713
16000,164,5875,7,196635,203164,6529
16000,214,5932,6,213762,246679,32917
16000,116,5926,7,176664,188919,12255
16000,142,5901,6,166714,235106,68392
16000,155,5922,8,173888,186869,12981
16000,275,5844,6,158602,212530,53928
16000,228,5893,8,143547,256441,112894
16000,172,5842,7,165951,220406,54455
16000,173,5949,7,247615,261621,14006
16000,282,5868,7,171693,245693,74000
16000,154,5901,6,165185,215610,50425
16000,41,5865,7,142523,184583,42060
16000,21,5906,7,156978,189098,32120
16000,153,5876,7,163755,200519,36764
16000,136,5862,6,179291,194567,15276
16000,116,5884,6,172690,221329,48639
16000,91,5907,7,152629,212045,59416
16000,95,5911,8,153463,188133,34670
16000,118,5870,6,163733,188922,25189
16000,75,5881,8,163523,194668,31145
16000,206,5937,7,187721,201150,13429
16000,144,5885,7,161772,191764,29992
16000,99,5856,7,138302,222179,83877
17000,43,6212,8,145921,195448,49527
17000,255,6260,7,145346,239890,94544
17000,97,6279,7,159590,203990,44400
17000,138,6250,7,152391,216274,63883
17000,195,6291,6,177965,203325,25360
17000,221,6200,7,155355,236194,80839
17000,125,6233,6,184994,234805,49811
17000,257,6238,7,151318,206426,55108
17000,85,6270,7,186014,238814,52800
17000,204,6226,8,199442,206013,6571
17000,103,6254,9,189420,190093,673
17000,30,6309,8,166367,273025,106658
17000,106,6247,7,167344,207589,40245
17000,192,6273,8,184259,207404,23145
17000,107,6239,8,184332,232128,47796
17000,119,6230,8,169196,226019,56823
17000,220,6228,9,191095,237654,46559
17000,125,6223,7,162221,220634,58413
17000,109,6279,7,199612,220437,20825
17000,352,6250,6,183198,214965,31767
17000,206,6204,7,172787,203866,31079
17000,38,6322,8,173991,242641,68650
17000,209,6289,7,167250,222269,55019
17000,276,6214,7,173450,188362,14912
17000,98,6280,7,196962,290173,93211
17000,370,6253,7,156372,222986,66614
17000,118,6276,6,161614,227990,66376
17000,70,6234,6,183839,219072,35233
17000,220,6269,7,142122,219321,77199
17000,148,6261,8,163699,198138,34439
17000,218,6276,7,164969,224624,59655
17000,7,6259,11,170507,193360,22853
17000,281,6203,7,154349,185872,31523
17000,191,6262,6,167728,222202,54474
17000,329,6260,6,160833,217890,57057
17000,17,6219,7,201426,202142,716
17000,104,6263,7,188879,282776,93897
17000,26,6247,9,161736,207265,45529
17000,112,6234,7,197350,247568,50218
17000,123,6274,7,199245,231536,32291
17000,411,6225,6,163736,217181,53445
17000,76,6286,6,150672,186577,35905
17000,297,6273,7,191015,191434,419
17000,231,6194,7,189723,219673,29950
17000,239,6298,7,141344,211230,69886
17000,121,6269,8,159976,217872,57896
17000,124,6236,7,187453,222269,34816
17000,105,6188,6,151067,253941,102874
17000,232,6236,7,207973,257892,49919
17000,334,6220,7,172926,214775,41849
18000,195,6598,7,194955,220143,25188
18000,163,6628,8,173175,255936,82761
18000,289,6617,8,183584,302292,118708
18000,90,6731,7,199290,236278,36988
18000,167,6646,6,172147,221880,49733
18000,79,6623,6,177494,204696,27202
18000,276,6589,8,181560,208738,27178
18000,88,6634,7,198741,231493,32752
18000,86,6646,6,171407,214854,43447
18000,241,6529,6,159131,216161,57030
18000,148,6620,7,194119,219077,24958
18000,110,6616,7,178539,292573,114034
18000,386,6595,7,210855,238517,27662
18000,126,6588,7,197421,235335,37914
18000,310,6585,6,200312,208278,7966
18000,65,6577,6,185172,233368,48196
18000,106,6615,6,211867,217330,5463
18000,68,6634,7,183792,200170,16378
18000,382,6624,7,172682,245056,72374
18000,113,6596,7,200275,227167,26892
18000,78,6660,7,246470,364625,118155
18000,139,6639,7,180193,206211,26018
18000,335,6622,7,194493,215673,21180
18000,68,6647,7,184205,301834,117629
18000,108,6611,7,164405,248618,84213
18000,242,6676,7,172139,246791,74652
18000,326,6649,6,199706,236997,37291
18000,45,6611,6,212047,218574,6527
18000,61,6596,8,227598,232310,4712
18000,103,6592,6,161987,211029,49042
18000,281,6689,7,203135,219952,16817
18000,131,6646,7,183845,230820,46975
18000,253,6643,7,197606,232139,34533
18000,66,6659,7,168679,231567,62888
18000,249,6561,7,184007,233691,49684
18000,216,6557,7,203314,258959,55645
18000,144,6592,9,158971,233818,74847
18000,220,6543,7,149047,240906,91859
18000,104,6581,6,174656,220501,45845
18000,187,6568,6,187066,214295,27229
18000,61,6707,7,234713,259317,24604
18000,100,6611,6,157489,226286,68797
18000,217,6648,6,163231,223523,60292
18000,269,6681,7,148419,217126,68707
18000,69,6638,6,179885,244472,64587
18000,117,6571,7,185323,233739,48416
18000,277,6599,7,165618,318798,153180
18000,177,6660,6,210292,231276,20984
18000,318,6549,7,196489,279463,82974
18000,74,6651,7,219673,248716,29043
19000,269,6905,6,178063,279609,101546
19000,63,6948,8,257507,269759,12252
19000,108,6979,7,202043,236613,34570
19000,62,7029,7,311662,316351,4689
19000,127,6950,8,163266,229168,65902
19000,315,6939,8,207014,244514,37500
19000,110,6954,6,222798,302042,79244
19000,241,6997,7,195985,244377,48392
19000,477,6982,7,184692,211280,26588
19000,84,7039,7,211327,226224,14897
19000,339,7015,7,182644,262902,80258
19000,172,6996,7,218178,274763,56585
19000,440,7051,7,198141,223818,25677
19000,64,7026,7,241235,258991,17756
19000,107,6969,7,205832,243223,37391
19000,79,7024,8,180804,215804,35000
19000,147,6953,7,204956,248962,44006
19000,65,6908,6,183848,271271,87423
19000,47,7041,7,167428,220821,53393
19000,91,7003,7,170672,258703,88031
19000,159,7024,7,194738,256228,61490
19000,125,6994,7,212806,235216,22410
19000,191,7028,7,208727,274023,65296
19000,42,6937,7,234588,240056,5468
19000,72,6996,8,198956,280381,81425
19000,152,7007,7,194749,220503,25754
19000,38,6974,10,198091,247670,49579
19000,122,6977,7,190161,242868,52707
19000,183,7001,6,270978,286772,15794
19000,158,6965,7,229777,234782,5005
19000,49,7001,6,234554,252347,17793
19000,50,6966,8,210006,236762,26756
19000,122,7014,7,221309,240235,18926
19000,82,6935,7,179815,228728,48913
19000,20,7005,7,159111,278502,119391
19000,416,6994,7,210343,236575,26232
19000,23,6939,6,176640,274856,98216
19000,168,6983,8,175345,228057,52712
19000,251,6883,6,210975,252175,41200
19000,97,7019,7,173407,241331,67924
19000,248,6973,6,170542,220488,49946
19000,265,6965,9,194174,277217,83043
19000,168,6998,7,185667,250066,64399
19000,253,7015,7,176706,231624,54918
19000,62,7023,7,206661,229427,22766
19000,161,6981,8,201439,277522,76083
19000,105,7006,7,164104,220534,56430
19000,140,6998,6,176859,211084,34225
19000,237,7019,6,214000,254682,40682
19000,220,6849,8,232082,271853,39771
20000,250,7401,6,226775,261578,34803
20000,94,7382,7,264327,282055,17728
20000,349,7386,7,224463,225910,1447
20000,221,7366,7,264530,301758,37228
20000,235,7357,8,206560,267844,61284
20000,108,7358,7,205544,269670,64126
20000,283,7356,7,212858,237915,25057
20000,191,7297,7,217086,244743,27657
20000,37,7321,7,170266,264343,94077
20000,225,7344,7,193262,222771,29509
20000,185,7320,7,204248,252973,48725
20000,27,7387,7,184426,258969,74543
20000,44,7446,10,193868,221332,27464
20000,140,7387,8,225615,268549,42934
20000,204,7363,7,211545,271210,59665
20000,99,7323,6,196265,234904,38639
20000,147,7391,7,208852,224616,15764
20000,55,7387,8,297939,324447,26508
20000,71,7378,7,215227,278790,63563
20000,348,7359,7,184797,263550,78753
20000,258,7397,7,178370,254402,76032
20000,110,7378,7,175840,219540,43700
20000,172,7311,7,237510,277986,40476
20000,204,7298,7,168900,234624,65724
20000,267,7399,7,200995,276944,75949
20000,162,7371,7,190267,266669,76402
20000,76,7353,7,189176,242829,53653
20000,318,7411,7,206559,243705,37146
20000,201,7331,7,214850,293434,78584
20000,110,7414,7,185669,220783,35114
20000,214,7326,6,239202,275262,36060
20000,314,7401,6,311686,336874,25188
20000,185,7354,7,200467,251538,51071
20000,272,7317,7,186140,262096,75956
20000,337,7386,7,207526,291967,84441
20000,78,7307,6,181666,231241,49575
20000,305,7394,7,195266,241909,46643
20000,202,7355,6,194103,264305,70202
20000,105,7429,7,175312,275229,99917
20000,137,7395,7,236391,250917,14526
20000,201,7323,6,184683,287925,103242
20000,152,7356,8,186144,244568,58424
20000,103,7343,7,205482,256137,50655
20000,133,7442,7,200642,257005,56363
20000,299,7412,7,186976,229510,42534
20000,91,7324,7,208218,230127,21909
20000,342,7341,7,158170,228454,70284
20000,305,7328,7,212020,253696,41676
20000,273,7363,7,252527,265828,13301
20000,144,7271,7,213026,226679,13653
21000,309,7680,7,286809,291913,5104
21000,441,7749,8,177537,247916,70379
21000,308,7713,7,211955,253409,41454
21000,270,7673,7,227326,283227,55901
21000,193,7722,8,191487,314472,122985
21000,52,7670,7,184593,248302,63709
21000,208,7745,7,287990,292595,4605
21000,409,7716,7,215275,245967,30692
21000,184,7744,7,203569,289566,85997
21000,174,7761,7,271394,297897,26503
21000,131,7753,6,213459,262052,48593
21000,35,7711,7,254745,310833,56088
21000,139,7732,7,254413,311757,57344
21000,283,7737,7,216646,241106,24460
21000,197,7697,7,220925,242899,21974
21000,124,7790,7,218676,328528,109852
21000,433,7713,7,221452,271763,50311
21000,134,7634,6,269658,333767,64109
21000,264,7724,6,241862,280946,39084
21000,234,7782,7,222615,292423,69808
21000,183,7791,6,200834,253393,52559
21000,193,7666,7,278555,332452,53897
21000,94,7663,7,184803,238422,53619
21000,264,7701,7,242974,258823,15849
21000,319,7678,7,207966,267559,59593
21000,320,7704,7,262073,295944,33871
21000,247,7755,7,220428,332435,112007
21000,204,7759,7,259151,283632,24481
21000,134,7717,6,229593,283343,53750
21000,241,7740,6,193698,283602,89904
21000,272,7733,7,293210,294725,1515
21000,123,7792,8,240115,274426,34311
21000,160,7695,7,221474,271369,49895
21000,125,7726,7,214405,231570,17165
21000,197,7781,7,200908,257911,57003
21000,147,7767,7,242739,278891,36152
21000,139,7711,7,212419,254983,42564
21000,186,7718,7,233209,293596,60387
21000,66,7752,7,212998,239821,26823
21000,58,7765,6,208408,236252,27844
21000,430,7683,7,223110,309456,86346
21000,338,7653,7,217899,250594,32695
21000,134,7720,7,220408,253911,33503
21000,72,7708,7,223481,276926,53445
21000,235,7738,6,232315,264263,31948
21000,282,7765,7,235992,322182,86190
21000,22,7814,7,190196,273004,82808
21000,112,7693,7,207869,290145,82276
21000,442,7576,7,228736,266943,38207
21000,196,7751,6,198679,247005,48326
22000,159,8213,7,255894,324963,69069
22000,194,8167,7,269851,306124,36273
22000,65,8060,7,201148,284118,82970
22000,237,8140,7,279664,314455,34791
22000,153,8179,6,215949,258674,42725
22000,132,8134,7,240369,309123,68754
22000,178,8027,7,177841,265858,88017
22000,340,8095,7,230462,360408,129946
22000,57,8085,8,252633,287365,34732
22000,91,8140,7,252411,299461,47050
22000,275,8060,7,211305,264071,52766
22000,199,8063,8,224387,321021,96634
22000,241,8058,7,247913,269533,21620
22000,80,8074,7,206508,294206,87698
22000,61,8112,7,270555,284330,13775
22000,235,8032,7,243399,277780,34381
22000,229,8084,7,212397,310265,97868
22000,283,8095,7,209132,273315,64183
22000,429,8158,7,244976,278774,33798
22000,91,8081,7,248264,281574,33310
22000,150,8113,7,259166,331909,72743
22000,106,8092,8,211921,306071,94150
22000,50,8139,6,305032,341013,35981
22000,20,8071,6,230374,316324,85950
22000,154,8049,7,201604,276210,74606
22000,97,8064,6,212501,261455,48954
22000,223,8198,7,282180,295024,12844
22000,217,8083,7,215818,325753,109935
22000,85,8048,6,207020,374191,167171
22000,222,8025,7,254403,279506,25103
22000,286,8030,8,196452,262445,65993
22000,237,8052,7,215066,330176,115110
22000,325,8112,6,204213,280182,75969
22000,47,7988,7,223161,299235,76074
22000,184,8039,7,227606,246457,18851
22000,314,8067,7,211689,267195,55506
22000,100,8078,7,260827,311367,50540
22000,118,8113,9,206444,295865,89421
22000,331,8162,7,215471,324746,109275
22000,251,8066,7,238063,264737,26674
22000,206,8059,7,216425,281169,64744
22000,218,8106,7,267095,290391,23296
22000,12,8090,6,241639,302707,61068
22000,196,8051,8,281150,375659,94509
22000,89,8087,7,209555,259626,50071
22000,189,8103,6,217573,274777,57204
22000,33,8048,8,204810,254369,49559
22000,242,8094,6,220174,289003,68829
22000,195,8097,7,240058,317764,77706
22000,48,8031,7,238767,286197,47430
23000,249,8399,7,236801,287454,50653
23000,36,8545,7,225030,290741,65711
23000,423,8478,7,293144,320368,27224
23000,304,8513,8,220505,271982,51477
23000,111,8375,7,218937,297257,78320
23000,463,8550,8,200648,281769,81121
23000,207,8448,6,201313,291145,89832
23000,152,8432,8,237833,317616,79783
23000,286,8396,6,260927,279168,18241
23000,55,8495,7,255947,295717,39770
23000,331,8504,7,258483,316586,58103
23000,224,8469,7,254936,275023,20087
23000,45,8498,7,230237,304554,74317
23000,189,8433,7,226160,294365,68205
23000,411,8423,6,245547,331874,86327
23000,75,8505,8,321593,387708,66115
23000,286,8427,7,215995,363427,147432
23000,142,8436,7,203654,265015,61361
23000,170,8427,7,298814,308425,9611
23000,153,8367,8,251823,382090,130267
23000,275,8493,7,233356,311707,78351
23000,259,8428,7,221718,312755,91037
23000,237,8439,6,235319,280777,45458
23000,141,8521,7,361192,365433,4241
23000,149,8439,7,231026,274782,43756
23000,298,8478,8,233206,287015,53809
23000,80,8483,7,200769,347910,147141
23000,186,8532,8,272293,305242,32949
23000,195,8442,8,340126,370092,29966
23000,199,8479,6,215154,255709,40555
23000,132,8478,8,261410,325148,63738
23000,118,8536,7,235544,281294,45750
23000,187,8504,7,240157,312777,72620
23000,360,8382,8,239285,333533,94248
23000,372,8460,8,254183,268267,14084
23000,232,8387,6,287135,329128,41993
23000,67,8557,7,246914,272319,25405
23000,129,8481,7,256816,351300,94484
23000,112,8494,7,225695,319175,93480
23000,249,8526,8,282803,305326,22523
23000,322,8450,7,223557,317658,94101
23000,272,8471,8,219245,305163,85918
23000,44,8473,7,221267,355378,134111
23000,134,8491,7,244255,306422,62167
23000,203,8519,7,257886,301409,43523
23000,168,8464,7,230802,276748,45946
23000,205,8431,8,243626,261698,18072
23000,100,8445,7,226212,298509,72297
23000,229,8434,7,217675,309035,91360
23000,151,8433,6,240949,289553,48604
24000,206,8883,6,254656,342048,87392
24000,186,8878,7,237476,304722,67246
24000,218,9011,8,239043,325663,86620
24000,97,8815,6,228453,294836,66383
24000,61,8886,8,258717,292849,34132
24000,268,8774,7,264821,398354,133533
24000,192,8797,7,240614,272558,31944
24000,278,8888,6,256952,287073,30121
24000,117,8886,7,320155,361501,41346
24000,264,8943,7,229781,345900,116119
24000,121,8839,9,274975,312119,37144
24000,147,8771,7,224685,297206,72521
24000,129,8781,7,227546,389722,162176
24000,213,8817,8,213778,310561,96783
24000,272,8847,7,284213,354362,70149
24000,130,8880,7,255567,274128,18561
24000,363,8883,7,247169,296874,49705
24000,95,8916,8,224752,301022,76270
24000,373,8889,7,216122,323917,107795
24000,169,8829,7,281505,310836,29331
24000,246,8784,6,236554,367426,130872
24000,122,8843,7,278426,304139,25713
24000,229,8784,8,264887,391137,126250
24000,340,8821,7,248232,359860,111628
24000,139,8823,7,269807,293379,23572
24000,203,8863,6,228563,333626,105063
24000,176,8772,7,256988,311913,54925
24000,221,8866,7,235100,340125,105025
24000,332,8835,8,241954,284393,42439
24000,301,8864,7,295058,342723,47665
24000,333,8877,7,275188,370215,95027
24000,148,8784,8,259355,348230,88875
24000,75,8898,7,270791,291052,20261
24000,169,8828,7,248854,294603,45749
24000,175,8768,7,278288,302695,24407
24000,79,8776,7,250765,332817,82052
24000,160,8826,7,232272,291393,59121
24000,108,8825,8,229808,303065,73257
24000,89,8831,7,265915,309960,44045
24000,175,8828,7,247753,320043,72290
24000,291,8787,7,201130,434108,232978
24000,268,8771,7,229106,351451,122345
24000,76,8824,6,216401,312580,96179
24000,204,8803,7,268901,302870,33969
24000,137,8903,8,247136,293004,45868
24000,367,8889,8,243583,366444,122861
24000,166,8706,7,215909,305171,89262
24000,113,8845,7,263571,290005,26434
24000,33,8846,7,231846,335263,103417
24000,45,8796,8,235656,329803,94147
25000,141,9124,6,253743,290533,36790
25000,103,9167,6,265674,354224,88550
25000,157,9190,6,254192,303092,48900
25000,228,9239,7,252782,340705,87923
25000,90,9264,7,299515,396571,97056
25000,130,9227,7,283071,306302,23231
25000,158,9197,10,282764,331673,48909
25000,35,9042,7,238497,363936,125439
25000,209,9256,8,269947,299634,29687
25000,111,9115,7,247409,333482,86073
25000,266,9183,9,220507,286797,66290
25000,70,9223,7,253236,307722,54486
25000,72,9091,8,249900,293877,43977
25000,71,9060,7,250409,301750,51341
25000,155,9138,6,271913,293466,21553
25000,404,9052,7,322000,335828,13828
25000,130,9325,7,257346,312674,55328
25000,21,9197,7,238437,300320,61883
25000,22,9244,7,259423,306652,47229
25000,165,9161,8,279036,341634,62598
25000,185,9285,7,364457,367618,3161
25000,187,9265,8,264250,321008,56758
25000,363,9192,7,297113,304652,7539
25000,230,9240,7,266345,375451,109106
25000,431,9242,8,244266,285746,41480
25000,138,9200,7,267130,349630,82500
25000,337,9273,7,249730,345041,95311
25000,93,9295,7,271761,301704,29943
25000,67,9163,7,319449,357320,37871
25000,172,9131,7,260497,294970,34473
25000,143,9187,6,263825,342072,78247
25000,237,9249,7,341286,356520,15234
25000,299,9168,7,296936,319777,22841
25000,110,9193,8,370163,382100,11937
25000,208,9136,7,278890,345442,66552
25000,256,9150,7,261350,316713,55363
25000,299,9187,7,313574,378061,64487
25000,162,9210,7,234162,290983,56821
25000,98,9123,7,223827,319561,95734
25000,255,9168,7,254550,295944,41394
25000,162,9137,7,227956,427607,199651
25000,269,9177,9,244702,321763,77061
25000,224,9055,7,281568,367086,85518
25000,406,9159,8,260865,318118,57253
25000,283,9174,7,249573,328177,78604
25000,316,9191,7,218845,310240,91395
25000,133,9240,7,281543,325611,44068
25000,269,9253,7,346261,355951,9690
25000,78,9183,7,259100,287629,28529
25000,141,9156,8,270398,292976,22578
26000,64,9607,7,369529,414045,44516
26000,26,9519,6,247187,344117,96930
26000,133,9642,7,271098,322807,51709
26000,252,9545,7,311770,352837,41067
26000,492,9592,8,281858,315021,33163
26000,97,9584,8,265287,318728,53441
26000,255,9534,8,252955,370212,117257
26000,157,9524,8,283920,344451,60531
26000,393,9546,8,273647,395274,121627
26000,129,9644,7,262973,364064,101091
26000,190,9541,7,319265,387367,68102
26000,210,9563,7,259984,310778,50794
26000,223,9620,7,283932,317165,33233
26000,224,9589,6,259543,397896,138353
26000,119,9539,7,256487,301928,45441
26000,15,9615,7,295507,319332,23825
26000,216,9563,7,240443,301514,61071
26000,284,9518,6,263623,380002,116379
26000,76,9656,7,249309,358048,108739
26000,301,9551,7,272878,381625,108747
26000,186,9564,8,304772,317132,12360
26000,210,9476,7,263917,322375,58458
26000,93,9476,7,272443,325971,53528
26000,177,9623,7,259453,304063,44610
26000,221,9557,7,274755,348401,73646
26000,162,9483,8,292245,330379,38134
26000,95,9552,7,238164,333987,95823
26000,190,9451,7,261854,309929,48075
26000,30,9723,7,306768,337100,30332
26000,228,9586,8,256902,309026,52124
26000,341,9533,7,269675,334160,64485
26000,399,9520,7,245710,360293,114583
26000,188,9628,7,256129,329607,73478
26000,178,9564,9,301278,310165,8887
26000,139,9521,7,271705,358491,86786
26000,154,9540,8,262953,358170,95217
26000,175,9566,6,296612,348539,51927
26000,294,9639,8,371173,374308,3135
26000,284,9507,8,252245,378010,125765
26000,126,9531,6,247550,325667,78117
26000,252,9568,8,295562,312626,17064
26000,225,9493,7,269753,318591,48838
26000,162,9559,7,242130,301145,59015
26000,96,9639,6,242871,415736,172865
26000,345,9595,7,320069,331284,11215
26000,23,9532,6,254887,333917,79030
26000,174,9500,7,275305,328143,52838
26000,197,9543,7,243833,331488,87655
26000,101,9524,7,270590,325503,54913
26000,239,9548,6,261673,345760,84087
27000,67,9915,8,296263,377766,81503
27000,118,9965,8,278396,332872,54476
27000,90,9907,7,263150,305447,42297
27000,320,10014,7,284642,363903,79261
27000,325,9934,7,279543,326452,46909
27000,262,9854,7,283075,361750,78675
27000,406,9946,8,311870,359293,47423
27000,110,9961,7,271667,440619,168952
27000,160,9942,7,314010,436114,122104
27000,231,9892,7,287850,317637,29787
27000,46,9947,7,275294,344021,68727
27000,186,9873,7,288576,315269,26693
27000,290,9867,8,286578,313063,26485
27000,344,9875,7,337588,416461,78873
27000,371,9922,7,311514,329006,17492
27000,187,9881,7,237942,315170,77228
27000,118,9972,7,329242,388996,59754
27000,249,9929,7,253350,349665,96315
27000,67,9937,7,360771,370879,10108
27000,91,10072,7,273774,338934,65160
27000,142,10061,9,307385,423261,115876
27000,277,9930,7,291166,343566,52400
27000,254,9871,7,314743,380580,65837
27000,224,9929,8,286345,327846,41501
27000,95,9943,8,333037,374062,41025
27000,150,9923,9,258518,384933,126415
27000,128,9999,7,298150,408782,110632
27000,97,9956,7,289114,312447,23333
27000,202,9833,8,271416,358943,87527
27000,315,9983,7,300800,386819,86019
27000,165,9978,8,304735,319959,15224
27000,345,9874,7,288351,389829,101478
27000,262,9980,8,338764,341110,2346
27000,218,9976,8,267878,338438,70560
27000,78,9903,7,267047,412796,145749
27000,390,9890,8,300613,358569,57956
27000,94,9955,6,291856,313269,21413
27000,141,9903,7,361882,380977,19095
27000,139,9919,7,244199,381714,137515
27000,356,9988,9,310716,350919,40203
27000,126,9975,7,339377,377960,38583
27000,51,10012,6,274948,369500,94552
27000,158,9861,8,276712,360506,83794
27000,213,10011,8,282648,352396,69748
27000,279,9963,7,284370,333184,48814
27000,346,9964,6,320899,363160,42261
27000,349,9921,7,311916,334572,22656
27000,190,9887,8,279612,323984,44372
27000,404,9940,7,355844,369276,13432
27000,183,9842,7,263000,328519,65519
28000,193,10258,7,301716,325231,23515
28000,380,10274,7,330866,407857,76991
28000,137,10338,7,306997,343582,36585
28000,156,10458,9,331493,373282,41789
28000,112,10296,7,280118,386344,106226
28000,165,10357,8,318470,458700,140230
28000,346,10311,7,346722,404344,57622
28000,180,10219,6,257925,369607,111682
28000,307,10344,7,364284,407318,43034
28000,79,10355,8,310078,375118,65040
28000,227,10327,7,338459,355729,17270
28000,323,10349,8,283022,362788,79766
28000,196,10308,8,290460,362231,71771
28000,245,10315,7,314984,342686,27702
28000,426,10338,7,300658,357030,56372
28000,163,10324,7,317194,489391,172197
28000,68,10257,7,311938,356604,44666
28000,46,10213,8,269935,330396,60461
28000,253,10402,8,359665,368294,8629
28000,145,10330,7,290070,373989,83919
28000,110,10229,7,311818,358187,46369
28000,250,10331,8,288579,337957,49378
28000,384,10330,8,305998,362939,56941
28000,129,10323,7,246260,467143,220883
28000,171,10311,6,329361,349848,20487
28000,158,10294,7,290603,392850,102247
28000,68,10332,7,290158,342747,52589
28000,303,10315,7,266918,326778,59860
28000,184,10413,7,305105,357504,52399
28000,422,10304,7,328554,377136,48582
28000,239,10202,7,379150,400533,21383
28000,156,10312,7,330257,359108,28851
28000,157,10348,7,343113,376142,33029
28000,230,10323,7,291987,366175,74188
28000,165,10330,8,299247,366122,66875
28000,183,10358,8,272608,420300,147692
28000,160,10264,7,247748,355182,107434
28000,215,10290,7,309762,369125,59363
28000,82,10414,9,339930,361738,21808
28000,211,10304,7,255682,323552,67870
28000,359,10322,8,284302,348875,64573
28000,224,10356,7,281039,383147,102108
28000,66,10316,7,269531,325921,56390
28000,124,10235,7,309942,342322,32380
28000,229,10347,7,299584,360448,60864
28000,385,10286,7,283519,331528,48009
28000,317,10264,8,257972,358887,100915
28000,61,10403,8,292835,307748,14913
28000,57,10299,7,257703,387903,130200
28000,432,10250,7,251069,364493,113424
29000,205,10644,8,346624,408312,61688
29000,269,10636,7,362832,387678,24846
29000,165,10677,7,283035,383984,100949
29000,208,10691,8,408821,434630,25809
29000,220,10685,7,265019,444777,179758
29000,553,10639,7,299747,381138,81391
29000,142,10672,7,283842,339650,55808
29000,345,10659,7,279138,353498,74360
29000,191,10651,8,306240,372250,66010
29000,120,10671,8,284545,360508,75963
29000,213,10660,8,260945,388434,127489
29000,300,10578,7,345661,394774,49113
29000,139,10723,7,496394,506871,10477
29000,97,10658,7,306643,339075,32432
29000,319,10585,6,278512,376213,97701
29000,64,10555,8,297246,394187,96941
29000,66,10596,7,306346,403284,96938
29000,234,10739,6,317932,390175,72243
29000,381,10729,7,327716,416706,88990
29000,237,10650,7,321320,373320,52000
29000,157,10601,7,275299,371624,96325
29000,139,10697,7,375326,407289,31963
29000,79,10677,7,309001,396237,87236
29000,63,10633,7,355732,393018,37286
29000,196,10646,7,318711,370870,52159
29000,229,10694,7,300955,334707,33752
29000,31,10594,8,276152,369078,92926
29000,150,10757,7,280131,375763,95632
29000,150,10627,7,265763,344659,78896
29000,61,10724,7,355134,432516,77382
29000,106,10683,7,351748,378631,26883
29000,142,10648,7,280625,423272,142647
29000,153,10640,7,320882,383821,62939
29000,258,10600,8,324177,374742,50565
29000,133,10626,7,364519,400502,35983
29000,99,10697,7,285556,395467,109911
29000,257,10724,7,285841,406666,120825
29000,135,10750,7,343733,347368,3635
29000,447,10716,8,311332,367757,56425
29000,245,10698,6,284438,344421,59983
29000,178,10721,8,302251,418239,115988
29000,201,10604,6,337633,450488,112855
29000,156,10649,7,318418,439226,120808
29000,119,10667,7,282979,389135,106156
29000,97,10631,7,295157,351734,56577
29000,185,10770,7,314013,369182,55169
29000,367,10674,7,396424,423012,26588
29000,273,10738,7,331427,336912,5485
29000,48,10645,7,302882,370887,68005
29000,276,10640,7,337149,415862,78713
30000,88,11136,7,342773,485135,142362
30000,117,11140,7,301771,392304,90533
30000,230,11070,7,290907,424526,133619
30000,54,11012,7,290106,376148,86042
30000,626,11035,7,287837,367282,79445
30000,151,11032,7,320137,388926,68789
30000,341,11000,8,308237,433580,125343
30000,114,10954,7,292293,364133,71840
30000,257,11042,7,300528,400281,99753
30000,200,11004,7,291755,381684,89929
30000,114,10995,7,285939,384250,98311
30000,219,11007,8,367482,430586,63104
30000,265,10994,6,292741,404278,111537
30000,189,10981,7,340687,411587,70900
30000,134,10966,7,318110,384478,66368
30000,306,11033,8,341434,390966,49532
30000,163,10991,7,369862,403757,33895
30000,93,11095,7,363781,448009,84228
30000,338,11018,7,371235,372297,1062
30000,74,10992,8,375905,613823,237918
30000,162,10997,6,293221,410279,117058
30000,103,11110,7,450383,476550,26167
30000,66,11020,8,339819,414011,74192
30000,172,11061,8,264591,351587,86996
30000,150,11142,7,297734,466422,168688
30000,161,11055,8,349221,396865,47644
30000,308,11020,6,301429,453803,152374
30000,128,11038,6,333474,410103,76629
30000,283,10964,7,302502,450470,147968
30000,53,10980,6,303492,370441,66949
30000,297,11058,7,254023,418763,164740
30000,320,11053,7,358762,451250,92488
30000,264,11116,7,285518,384676,99158
30000,84,11053,6,290832,385323,94491
30000,506,10988,7,316856,368699,51843
30000,439,11003,7,297211,354505,57294
30000,314,11084,7,388142,403473,15331
30000,360,11020,8,338374,429526,91152
30000,231,11065,7,268739,459521,190782
30000,280,11003,7,287171,391792,104621
30000,109,11064,8,402602,442186,39584
30000,356,11073,8,307490,372047,64557
30000,189,11016,7,297849,449767,151918
30000,233,11116,9,292489,479375,186886
30000,90,10966,8,321354,428239,106885
30000,178,10960,7,340274,372290,32016
30000,131,11122,8,291286,447332,156046
30000,97,11003,7,355151,445895,90744
30000,150,11021,9,345342,409856,64514
30000,370,11070,7,341314,419155,77841
31000,321,11470,7,357088,392799,35711
31000,396,11415,7,296156,382793,86637
31000,333,11422,6,354016,447005,92989
31000,193,11384,7,320967,388069,67102
31000,104,11385,7,377147,447643,70496
31000,291,11415,7,386749,462879,76130
31000,144,11313,7,336376,431695,95319
31000,176,11419,7,349918,426015,76097
31000,219,11449,9,408000,426822,18822
31000,234,11428,7,311118,387877,76759
31000,48,11327,7,299743,477382,177639
31000,327,11373,7,298537,405928,107391
31000,160,11472,8,318285,386382,68097
31000,279,11500,8,332385,405719,73334
31000,456,11387,8,325739,396044,70305
31000,28,11450,9,309111,391772,82661
31000,204,11405,7,303706,407820,104114
31000,210,11407,7,343439,398467,55028
31000,212,11381,7,339121,367682,28561
31000,205,11409,8,331220,505578,174358
31000,211,11386,8,365550,408758,43208
31000,405,11484,6,330055,397110,67055
31000,235,11380,8,285659,372912,87253
31000,210,11403,7,320618,366712,46094
31000,279,11382,7,359140,379635,20495
31000,494,11411,7,386203,460730,74527
31000,31,11438,7,394753,447506,52753
31000,215,11404,7,279041,409980,130939
31000,281,11369,7,351168,373085,21917
31000,228,11423,8,337993,392293,54300
31000,274,11380,7,306185,444427,138242
31000,209,11403,6,329835,401809,71974
31000,224,11537,7,343573,352636,9063
31000,301,11498,8,301463,396853,95390
31000,151,11392,7,354078,439217,85139
31000,36,11408,7,318746,443287,124541
31000,248,11383,6,392619,403312,10693
31000,147,11371,7,445182,464086,18904
31000,159,11430,8,339553,405772,66219
31000,275,11399,7,280457,432597,152140
31000,158,11415,8,308758,514367,205609
31000,302,11451,7,301552,418795,117243
31000,255,11478,7,302604,392955,90351
31000,21,11365,8,395581,412615,17034
31000,141,11464,7,369354,380700,11346
31000,244,11400,7,296793,382446,85653
31000,195,11314,9,317429,388799,71370
31000,242,11417,7,398564,407108,8544
31000,51,11464,7,410224,436647,26423
31000,118,11293,7,343191,412221,69030
32000,178,11795,7,335608,415563,79955
32000,134,11751,6,320563,366836,46273
32000,127,11861,8,361765,406625,44860
32000,191,11799,7,403639,479550,75911
32000,291,11810,6,361387,400601,39214
32000,301,11711,7,349528,417944,68416
32000,56,11724,6,330943,397153,66210
32000,224,11812,7,394796,459725,64929
32000,104,11796,7,366703,435923,69220
32000,122,11771,7,320850,402554,81704
32000,141,11812,7,423854,459668,35814
32000,183,11816,8,315949,435373,119424
32000,90,11829,8,349753,492152,142399
32000,136,11794,6,395581,500801,105220
32000,308,11653,8,349484,384280,34796
32000,325,11750,8,416437,434171,17734
32000,150,11770,8,325999,401470,75471
32000,235,11777,7,354443,433511,79068
32000,235,11675,8,364957,471920,106963
32000,327,11747,7,320369,367810,47441
32000,178,11835,8,337569,408093,70524
32000,357,11778,7,382447,456596,74149
32000,306,11789,7,324319,479598,155279
32000,375,11797,8,366968,439242,72274
32000,133,11742,8,331344,486902,155558
32000,220,11665,7,312221,436258,124037
32000,463,11735,7,299475,389848,90373
32000,89,11857,8,340484,386603,46119
32000,148,11773,7,376636,572054,195418
32000,215,11809,7,362839,419171,56332
32000,60,11884,7,406688,427014,20326
32000,196,11744,7,376463,415566,39103
32000,271,11775,7,388966,403810,14844
32000,32,11795,7,331721,406753,75032
32000,186,11793,7,387905,515241,127336
32000,252,11845,8,308364,383796,75432
32000,135,11834,7,378187,418016,39829
32000,339,11803,7,325946,396915,70969
32000,271,11793,7,439111,448331,9220
32000,282,11785,6,365932,397347,31415
32000,258,11739,7,303206,387803,84597
32000,346,11764,7,385797,430246,44449
32000,213,11640,7,444467,473351,28884
32000,343,11716,7,305922,427002,121080
32000,258,11706,7,315859,440760,124901
32000,385,11748,8,351999,475956,123957
32000,362,11798,7,316635,424185,107550
32000,322,11744,8,389554,397221,7667
32000,205,11868,7,359440,460275,100835
32000,271,11768,8,336081,414516,78435
33000,118,12165,7,370215,462342,92127
33000,180,12242,7,410928,462303,51375
33000,466,12115,7,389848,430216,40368
33000,55,12144,7,315776,424215,108439
33000,230,12147,9,347507,424438,76931
33000,495,12067,7,345954,459413,113459
33000,260,12203,7,300934,398752,97818
33000,365,12149,8,360346,413602,53256
33000,212,12115,7,404332,456623,52291
33000,296,12090,7,390547,459362,68815
33000,324,12168,7,315806,454604,138798
33000,247,12132,8,332259,412755,80496
33000,214,12148,7,328305,396308,68003
33000,619,12125,7,381856,410205,28349
33000,292,12223,8,371493,494035,122542
33000,204,12242,8,361881,588959,227078
33000,631,12219,7,387152,401532,14380
33000,306,12110,8,354412,516143,161731
33000,302,12147,7,326877,468296,141419
33000,228,12251,7,357117,389000,31883
33000,79,12161,7,328530,464086,135556
33000,113,12054,7,371272,474595,103323
33000,167,12136,6,425615,485997,60382
33000,99,12184,7,349676,479075,129399
33000,174,12187,7,405747,416421,10674
33000,293,12102,7,328061,384598,56537
33000,136,12153,8,404984,623571,218587
33000,510,12154,8,356301,437776,81475
33000,329,12131,7,398160,401053,2893
33000,221,12211,7,319926,392176,72250
33000,292,12122,6,376136,451777,75641
33000,116,12160,7,358139,455313,97174
33000,370,12201,7,294684,420834,126150
33000,170,12103,7,471627,503418,31791
33000,274,12170,9,334717,392422,57705
33000,315,12107,7,362323,429047,66724
33000,143,12134,7,309398,490482,181084
33000,233,12181,8,503136,504759,1623
33000,161,12129,7,359339,519761,160422
33000,212,12096,8,420368,425139,4771
33000,106,12182,7,370708,429454,58746
33000,163,12199,8,330488,407930,77442
33000,285,12150,7,367814,408520,40706
33000,53,12059,7,358084,426273,68189
33000,133,12169,7,422307,469827,47520
33000,388,12154,8,400586,403223,2637
33000,360,12098,7,450825,512016,61191
33000,509,12118,7,441729,479703,37974
33000,112,12125,7,349374,420226,70852
33000,279,12230,7,361315,474754,113439
34000,489,12552,7,369208,516615,147407
34000,158,12611,7,324971,499759,174788
34000,179,12543,7,385706,407485,21779
34000,373,12507,7,381377,432259,50882
34000,191,12525,7,332331,471973,139642
34000,176,12544,7,338745,440540,101795
34000,118,12521,7,465126,529059,63933
34000,175,12563,7,343660,474252,130592
34000,143,12509,8,391758,588648,196890
34000,142,12606,8,489299,552950,63651
34000,394,12470,8,462366,508638,46272
34000,194,12527,7,364076,416051,51975
34000,307,12472,7,456945,519454,62509
34000,179,12526,7,368413,430683,62270
34000,74,12541,7,357211,419432,62221
34000,441,12565,7,407778,444984,37206
34000,385,12511,7,332437,454730,122293
34000,266,12591,7,368928,489650,120722
34000,138,12481,7,365102,425488,60386
34000,306,12429,7,331451,595713,264262
34000,323,12513,7,361619,419546,57927
34000,158,12497,7,441000,474907,33907
34000,119,12445,7,368803,466643,97840
34000,422,12533,7,335868,494103,158235
34000,354,12533,7,384780,419695,34915
34000,515,12468,7,388729,470769,82040
34000,210,12575,7,382857,446567,63710
34000,166,12441,7,363689,453722,90033
34000,121,12537,7,363009,482393,119384
34000,382,12470,7,350657,419299,68642
34000,489,12562,7,348640,445961,97321
34000,63,12512,7,350344,536208,185864
34000,531,12616,7,387144,450329,63185
34000,276,12488,7,364120,451515,87395
34000,268,12523,8,326367,481714,155347
34000,222,12492,9,428867,447967,19100
34000,231,12478,8,379544,466520,86976
34000,176,12463,8,360319,420170,59851
34000,208,12454,7,340224,493087,152863
34000,172,12492,7,436167,468283,32116
34000,184,12574,8,329599,559102,229503
34000,343,12496,8,318611,439314,120703
34000,236,12457,7,421416,449379,27963
34000,77,12598,7,365307,462992,97685
34000,252,12593,7,354861,503232,148371
34000,164,12544,6,379795,410401,30606
34000,74,12606,7,339717,466996,127279
34000,192,12380,7,416988,467342,50354
34000,362,12464,7,384612,422161,37549
34000,241,12443,8,353790,405527,51737
35000,229,12873,7,442617,505365,62748
35000,574,12859,7,367580,460615,93035
35000,260,12882,7,375989,482403,106414
35000,479,12946,8,324217,494058,169841
35000,101,12839,7,367007,468290,101283
35000,115,12792,7,352848,451031,98183
35000,231,12927,7,393995,450075,56080
35000,305,12851,7,371114,500744,129630
35000,123,12856,8,350034,497636,147602
35000,215,12883,7,519075,520099,1024
35000,371,12854,7,365981,473742,107761
35000,179,12835,8,437909,492040,54131
35000,327,12903,7,402284,510274,107990
35000,445,12981,7,341621,465309,123688
35000,144,12881,7,440660,496374,55714
35000,223,12902,9,385171,484607,99436
35000,186,12786,7,369703,441239,71536
35000,166,12953,8,396037,472812,76775
35000,350,12856,7,375245,476828,101583
35000,97,12952,8,387030,470093,83063
35000,387,12938,7,368745,410865,42120
35000,104,12882,7,327683,493500,165817
35000,138,12898,7,317667,470681,153014
35000,207,12881,7,362009,437498,75489
35000,194,12801,8,332429,455800,123371
35000,154,12892,7,388862,473955,85093
35000,78,12857,6,409591,464078,54487
35000,81,12796,7,475319,549106,73787
35000,262,12973,7,411191,468703,57512
35000,147,12796,7,358709,471626,112917
35000,398,12899,8,317415,439509,122094
35000,224,12813,7,395288,438870,43582
35000,370,12857,7,354784,479299,124515
35000,131,12861,7,381549,477772,96223
35000,195,12862,7,375444,481351,105907
35000,222,12981,7,354893,459226,104333
35000,214,12786,9,361635,467623,105988
35000,79,12829,7,383587,489470,105883
35000,384,13022,7,369234,479356,110122
35000,124,12812,6,368450,557354,188904
35000,209,12875,8,502393,516590,14197
35000,196,12818,8,360345,443211,82866
35000,499,12837,7,382672,410982,28310
35000,139,12847,9,415372,459047,43675
35000,262,12855,7,429807,482228,52421
35000,369,12791,7,361704,438421,76717
35000,46,12936,7,302273,442526,140253
35000,437,12852,7,410478,456778,46300
35000,160,12826,8,367132,439559,72427
35000,9,12887,7,471426,631903,160477
36000,237,13181,7,344263,454658,110395
36000,108,13240,7,360060,456381,96321
36000,185,13350,7,474032,476873,2841
36000,243,13157,8,322049,495276,173227
36000,489,13342,7,404784,543325,138541
36000,286,13257,7,421127,524910,103783
36000,303,13234,7,356754,516027,159273
36000,161,13213,7,362391,496905,134514
36000,500,13218,7,378013,539008,160995
36000,330,13247,8,389545,506167,116622
36000,226,13270,7,377670,530151,152481
36000,415,13237,8,374207,483642,109435
36000,206,13274,7,403567,456732,53165
36000,83,13253,7,421974,451216,29242
36000,37,13204,8,365731,454447,88716
36000,208,13163,8,358455,446328,87873
36000,362,13335,7,353944,505305,151361
36000,61,13401,7,399369,550695,151326
36000,42,13312,7,330542,427821,97279
36000,155,13319,8,367702,492488,124786
36000,319,13259,8,372335,534796,162461
36000,496,13219,7,361668,537515,175847
36000,131,13242,7,432573,478896,46323
36000,155,13244,7,442493,471858,29365
36000,273,13149,7,456104,481195,25091
36000,383,13212,7,403614,548450,144836
36000,85,13145,7,410642,462454,51812
36000,246,13238,7,385605,494167,108562
36000,67,13215,7,320274,474098,153824
36000,579,13370,8,371024,466961,95937
36000,162,13193,9,361692,477394,115702
36000,12,13295,7,371554,486852,115298
36000,266,13394,7,390510,465338,74828
36000,304,13128,7,369459,534003,164544
36000,457,13304,7,398597,414683,16086
36000,241,13167,8,527015,556299,29284
36000,106,13214,7,411263,441732,30469
36000,71,13239,7,420906,450387,29481
36000,129,13263,6,369914,461083,91169
36000,204,13285,7,400393,452098,51705
36000,106,13347,9,385117,426478,41361
36000,300,13054,7,388222,559090,170868
36000,430,13282,7,338631,503513,164882
36000,161,13304,10,406615,469283,62668
36000,351,13280,8,375782,475478,99696
36000,259,13354,8,328870,468762,139892
36000,184,13370,7,412828,452213,39385
36000,130,13229,7,351264,509874,158610
36000,205,13242,6,352713,480782,128069
36000,288,13356,8,464948,485000,20052
37000,73,13707,8,364238,555002,190764
37000,82,13557,7,335845,439481,103636
37000,307,13652,7,450962,494796,43834
37000,302,13536,7,368532,458235,89703
37000,158,13723,8,377939,474797,96858
37000,149,13569,6,412555,473154,60599
37000,286,13445,7,400468,556192,155724
37000,338,13601,7,479674,540558,60884
37000,38,13699,8,402150,489993,87843
37000,143,13661,7,456159,520423,64264
37000,111,13572,8,400845,443000,42155
37000,96,13642,7,421194,434812,13618
37000,389,13666,7,382092,475510,93418
37000,282,13617,7,410414,431892,21478
37000,396,13574,7,365853,464735,98882
37000,108,13637,7,356706,581460,224754
37000,228,13612,7,417802,513078,95276
37000,319,13584,6,474888,506585,31697
37000,88,13583,7,435927,465363,29436
37000,198,13578,7,374811,553433,178622
37000,171,13651,7,431578,482963,51385
37000,224,13624,7,351790,498833,147043
37000,243,13609,7,448016,543251,95235
37000,428,13614,7,410883,460677,49794
37000,368,13584,8,364313,511783,147470
37000,405,13629,7,443468,482822,39354
37000,149,13623,7,368297,579301,211004
37000,241,13559,7,374938,524135,149197
37000,82,13636,7,423989,514781,90792
37000,341,13586,7,368338,530093,161755
37000,199,13686,7,458912,484787,25875
37000,141,13559,7,465486,474239,8753
37000,61,13544,7,444835,507378,62543
37000,497,13646,6,480598,540372,59774
37000,102,13569,8,410474,440322,29848
37000,80,13547,7,401464,503003,101539
37000,121,13526,8,446907,587504,140597
37000,239,13675,7,412123,495187,83064
37000,205,13685,7,415617,503872,88255
37000,406,13593,8,432573,523705,91132
37000,422,13639,7,420434,452108,31674
37000,97,13626,7,344878,540804,195926
37000,42,13620,7,457845,505158,47313
37000,103,13579,7,395842,516926,121084
37000,105,13657,7,429663,468735,39072
37000,187,13554,7,335858,461795,125937
37000,165,13652,10,423585,538823,115238
37000,403,13558,8,419099,512091,92992
37000,113,13695,7,375103,414807,39704
37000,320,13582,7,377634,487366,109732
38000,450,13932,8,476415,538022,61607
38000,357,13939,7,387638,489920,102282
38000,169,14123,7,485538,493260,7722
38000,265,13906,7,443977,500760,56783
38000,356,13991,8,499963,641500,141537
38000,372,13889,7,424981,461701,36720
38000,245,13982,8,391530,453664,62134
38000,323,13986,8,386562,474328,87766
38000,365,13979,8,426991,473078,46087
38000,205,13987,7,432631,487081,54450
38000,61,14036,7,405836,532560,126724
38000,422,13878,7,419710,516389,96679
38000,180,13903,8,363593,429327,65734
38000,159,14037,7,419855,464424,44569
38000,239,14008,8,486688,530473,43785
38000,348,13944,6,444835,534813,89978
38000,85,14010,7,379358,511058,131700
38000,55,14076,7,390906,493532,102626
38000,186,14107,7,416515,638452,221937
38000,267,14016,7,408657,568859,160202
38000,65,13906,9,394573,593556,198983
38000,34,13995,7,430679,528802,98123
38000,171,14025,9,394317,446093,51776
38000,57,14129,7,507112,543252,36140
38000,136,14008,7,465622,522528,56906
38000,111,13916,7,426758,496096,69338
38000,277,13922,9,499850,514159,14309
38000,512,13910,7,379223,503722,124499
38000,289,13993,8,464518,518839,54321
38000,110,13970,7,411635,463457,51822
38000,248,14034,6,486832,497515,10683
38000,212,14082,7,449456,480491,31035
38000,167,13952,7,432181,502357,70176
38000,233,13910,7,360598,531667,171069
38000,406,14040,7,411600,525188,113588
38000,549,14017,8,446956,510688,63732
38000,484,13952,10,390290,508713,118423
38000,102,13942,7,412218,474487,62269
38000,480,13964,7,383468,565456,181988
38000,359,13965,8,392173,462249,70076
38000,218,14032,7,383361,533020,149659
38000,400,13930,7,387377,478483,91106
38000,56,13976,7,410136,527571,117435
38000,52,14122,7,425351,500881,75530
38000,351,14044,7,396721,572189,175468
38000,244,14077,8,436061,468030,31969
38000,137,14137,7,432280,532476,100196
38000,399,14060,8,510326,513679,3353
38000,130,13991,7,484449,518914,34465
38000,343,13965,8,387761,493515,105754
39000,321,14243,7,453351,529276,75925
39000,337,14356,7,410404,515583,105179
39000,161,14282,7,399615,591295,191680
39000,135,14241,7,413611,534707,121096
39000,72,14308,7,492512,565518,73006
39000,202,14336,8,426615,628025,201410
39000,32,14250,6,407924,518731,110807
39000,391,14313,7,492480,508554,16074
39000,240,14305,7,475547,538074,62527
39000,298,14320,7,413697,487961,74264
39000,266,14376,7,459623,519320,59697
39000,126,14306,7,471156,592552,121396
39000,215,14411,7,434474,473542,39068
39000,379,14434,10,410777,533346,122569
39000,236,14222,7,401060,483222,82162
39000,220,14410,7,516462,585120,68658
39000,429,14326,7,367402,534473,167071
39000,298,14335,7,399881,499109,99228
39000,114,14367,7,405633,485066,79433
39000,127,14326,7,408006,524936,116930
39000,335,14401,7,503670,560279,56609
39000,88,14362,7,453882,526093,72211
39000,277,14376,7,382758,520609,137851
39000,28,14326,7,433680,517864,84184
39000,288,14404,7,461729,505749,44020
39000,352,14327,7,359939,548815,188876
39000,517,14341,8,464278,528270,63992
39000,49,14293,7,554306,565782,11476
39000,343,14395,7,474001,598202,124201
39000,81,14329,7,368169,571922,203753
39000,329,14361,7,470191,742927,272736
39000,254,14288,8,392997,597877,204880
39000,204,14348,6,480684,504646,23962
39000,58,14320,8,497084,510417,13333
39000,306,14261,7,400979,520024,119045
39000,449,14277,7,446459,532762,86303
39000,170,14319,7,470020,608727,138707
39000,151,14330,7,500718,650714,149996
39000,42,14233,10,417097,508907,91810
39000,126,14365,7,470604,627699,157095
39000,275,14374,8,487051,581235,94184
39000,280,14375,7,415549,519010,103461
39000,282,14402,8,430170,508965,78795
39000,244,14324,7,400502,549550,149048
39000,79,14226,7,505299,682672,177373
39000,693,14431,7,434511,516436,81925
39000,78,14308,8,395556,559618,164062
39000,241,14246,7,491217,539833,48616
39000,272,14348,6,533621,609735,76114
39000,154,14421,8,458332,533429,75097
40000,382,14730,8,445490,587864,142374
40000,264,14765,8,408315,511064,102749
40000,385,14630,7,408815,526173,117358
40000,170,14802,7,412842,590967,178125
40000,357,14705,6,486368,569723,83355
40000,104,14674,7,447068,491115,44047
40000,261,14693,7,398515,534894,136379
40000,122,14712,7,428848,576546,147698
40000,307,14626,7,422271,533627,111356
40000,261,14766,7,459583,518331,58748
40000,288,14684,8,459719,527798,68079
40000,279,14687,7,481520,515725,34205
40000,272,14637,7,428290,527575,99285
40000,377,14626,7,466005,588081,122076
40000,418,14804,7,379382,638239,258857
40000,377,14805,7,473684,619569,145885
40000,519,14830,7,424216,524548,100332
40000,194,14630,7,434761,603073,168312
40000,205,14645,7,453197,541627,88430
40000,272,14730,8,374365,512460,138095
40000,58,14542,7,502509,614113,111604
40000,191,14788,8,409275,479685,70410
40000,317,14819,7,462946,583911,120965
40000,149,14721,7,443237,565368,122131
40000,274,14679,7,429697,508689,78992
40000,113,14667,7,551873,578838,26965
40000,451,14756,7,461718,557500,95782
40000,99,14766,7,474516,535227,60711
40000,438,14720,7,456693,552497,95804
40000,170,14755,7,376543,486275,109732
40000,104,14688,7,434167,462718,28551
40000,372,14762,7,424682,516265,91583
40000,165,14788,7,465025,510983,45958
40000,191,14708,7,419283,515602,96319
40000,310,14765,7,602055,678663,76608
40000,371,14736,7,400894,517256,116362
40000,462,14685,8,411042,600309,189267
40000,258,14681,7,396317,564625,168308
40000,283,14702,7,389902,577214,187312
40000,136,14611,7,488353,512699,24346
40000,337,14637,8,454922,557557,102635
40000,368,14689,8,419016,615669,196653
40000,477,14659,7,397889,497847,99958
40000,216,14749,7,416015,499792,83777
40000,185,14834,7,393457,556059,162602
40000,270,14715,8,469324,665272,195948
40000,409,14685,7,509162,591661,82499
40000,238,14712,7,506362,568547,62185
40000,151,14794,7,586497,634935,48438
40000,421,14746,7,371975,473888,101913
41000,42,15033,7,470903,507527,36624
41000,488,15168,7,434792,535849,101057
41000,425,15110,7,570150,588431,18281
41000,472,15228,8,511988,520761,8773
41000,72,15097,7,440213,531289,91076
41000,223,15142,7,392113,543567,151454
41000,184,15044,7,420421,559934,139513
41000,44,14906,9,400301,514023,113722
41000,48,15142,7,454705,529547,74842
41000,132,15044,8,417912,618498,200586
41000,383,15061,8,385557,490002,104445
41000,287,14988,8,479496,559990,80494
41000,94,15105,8,437712,522334,84622
41000,346,15198,7,446107,703020,256913
41000,160,15072,8,486319,536759,50440
41000,200,15056,8,423663,510617,86954
41000,244,15107,7,506231,545053,38822
41000,270,15163,6,424607,586548,161941
41000,279,15063,8,443362,558746,115384
41000,514,15078,6,427695,611028,183333
41000,117,15046,9,484688,640367,155679
41000,204,15143,8,453481,519554,66073
41000,177,14923,7,479597,533385,53788
41000,191,15104,7,442809,615342,172533
41000,402,15126,7,399568,510599,111031
41000,277,15084,9,468394,634842,166448
41000,291,15173,8,395673,641418,245745
41000,312,15087,7,421211,601013,179802
41000,402,15129,8,427384,531006,103622
41000,330,14986,7,579425,638445,59020
41000,122,15078,7,449324,528601,79277
41000,339,15122,7,589695,622142,32447
41000,125,15061,8,405084,537585,132501
41000,409,15125,7,574268,591542,17274
41000,500,15148,7,436620,648897,212277
41000,151,15153,7,456833,566235,109402
41000,85,15093,8,439451,585446,145995
41000,331,14991,7,432426,604494,172068
41000,388,15036,8,460481,623605,163124
41000,254,14989,7,493081,595427,102346
41000,655,15096,8,583853,604453,20600
41000,521,15138,8,461249,563423,102174
41000,250,15024,8,475207,549735,74528
41000,156,15089,8,476872,560075,83203
41000,225,15128,7,432812,533426,100614
41000,110,15068,8,416558,628959,212401
41000,274,15116,7,408603,562398,153795
41000,431,15087,7,540117,549999,9882
41000,37,15125,7,413118,575990,162872
41000,287,15102,8,424910,547503,122593
42000,212,15561,8,390502,603197,212695
42000,188,15360,8,503976,586099,82123
42000,250,15515,7,555065,558932,3867
42000,310,15423,7,442252,577367,135115
42000,182,15339,7,528770,565200,36430
42000,425,15446,9,435450,578840,143390
42000,21,15532,7,462099,625705,163606
42000,345,15531,8,438080,500278,62198
42000,228,15376,9,533744,535276,1532
42000,342,15548,7,386151,534944,148793
42000,140,15466,7,428310,579243,150933
42000,153,15562,8,439845,566735,126890
42000,230,15476,7,463156,630800,167644
42000,346,15358,6,371370,588127,216757
42000,313,15391,8,513140,530505,17365
42000,430,15551,7,469272,544730,75458
42000,355,15297,7,472294,626045,153751
42000,325,15415,8,462906,585356,122450
42000,667,15519,7,492390,579557,87167
42000,509,15556,7,449101,531786,82685
42000,109,15499,7,436298,692248,255950
42000,230,15460,7,484220,572298,88078
42000,442,15563,7,511370,603551,92181
42000,138,15504,8,450224,537754,87530
42000,341,15539,7,519308,537201,17893
42000,438,15420,9,410058,599955,189897
42000,265,15379,8,446854,721511,274657
42000,352,15461,7,458075,514947,56872
42000,346,15409,7,414857,588897,174040
42000,181,15439,7,425462,561624,136162
42000,335,15438,7,453960,516253,62293
42000,141,15446,7,450732,660844,210112
42000,437,15403,7,419341,609061,189720
42000,449,15423,7,594267,676767,82500
42000,327,15440,7,408841,607008,198167
42000,618,15439,8,422682,573191,150509
42000,201,15503,7,434318,557370,123052
42000,370,15472,7,457180,583369,126189
42000,268,15491,7,569693,600166,30473
42000,152,15340,7,383424,585916,202492
42000,238,15483,7,437706,636940,199234
42000,252,15496,8,546482,553990,7508
42000,193,15386,7,434572,544301,109729
42000,262,15444,7,431894,624256,192362
42000,238,15290,7,485378,735230,249852
42000,71,15490,8,447762,583126,135364
42000,230,15374,7,421326,575394,154068
42000,491,15499,8,468135,525254,57119
42000,342,15457,8,532879,578347,45468
42000,98,15486,7,474499,570391,95892
43000,271,15850,7,443658,574604,130946
43000,263,15870,9,475478,622038,146560
43000,360,15715,7,499296,519260,19964
43000,173,15894,8,445443,547929,102486
43000,182,15881,7,462232,653939,191707
43000,346,15898,8,538251,569956,31705
43000,352,15835,8,398496,698733,300237
43000,277,15768,8,461019,570344,109325
43000,272,15885,8,437035,563769,126734
43000,325,15717,7,554212,564706,10494
43000,167,15802,7,480312,654242,173930
43000,154,15748,7,473271,569288,96017
43000,95,15795,7,434806,599291,164485
43000,422,15886,7,435909,623274,187365
43000,270,15854,8,496170,583571,87401
43000,310,15816,8,421050,560958,139908
43000,124,15824,8,445222,519677,74455
43000,378,15715,7,522585,590633,68048
43000,329,15872,7,449249,531339,82090
43000,434,15807,7,681922,697566,15644
43000,196,15828,7,441726,533405,91679
43000,74,15923,7,498064,570257,72193
43000,234,15750,8,512493,614943,102450
43000,56,15727,8,393574,554296,160722
43000,222,15918,7,469827,589080,119253
43000,345,15802,7,462124,552150,90026
43000,175,15747,8,469176,579215,110039
43000,414,15764,7,504038,754359,250321
43000,174,15867,8,511721,573197,61476
43000,51,15825,8,448490,596357,147867
43000,150,15858,9,496407,544093,47686
43000,233,15784,8,434564,538173,103609
43000,198,15795,7,517202,656579,139377
43000,365,15759,7,444398,561221,116823
43000,277,15817,7,455143,520296,65153
43000,101,15890,7,467719,593026,125307
43000,359,15781,7,444257,628857,184600
43000,45,15805,8,457523,583445,125922
43000,231,15818,8,452175,562765,110590
43000,263,15749,8,459428,623043,163615
43000,284,15798,7,423629,728744,305115
43000,154,15747,7,482156,589652,107496
43000,162,15742,8,489862,629147,139285
43000,85,15730,7,491489,510514,19025
43000,57,15890,8,461741,524823,63082
43000,82,15767,7,444576,614235,169659
43000,132,15886,7,438910,576152,137242
43000,520,15831,6,455208,704769,249561
43000,302,15873,7,434957,504630,69673
43000,203,15714,7,567240,662014,94774
44000,318,16199,7,449155,522434,73279
44000,55,16209,6,541855,594879,53024
44000,778,16202,8,475627,558286,82659
44000,338,16278,7,488289,648200,159911
44000,348,16282,7,574234,704612,130378
44000,200,16173,7,430881,577533,146652
44000,305,16222,7,440670,552211,111541
44000,462,16192,7,503845,594346,90501
44000,413,16069,7,669746,723544,53798
44000,347,16197,7,461299,579005,117706
44000,126,16146,7,567966,599443,31477
44000,194,16208,7,445748,573450,127702
44000,210,16278,7,525355,573382,48027
44000,379,16205,7,517165,614318,97153
44000,267,16329,7,476918,585316,108398
44000,223,16112,8,482134,581459,99325
44000,360,16280,7,512196,581385,69189
44000,373,16093,8,449763,589572,139809
44000,16,16152,7,542245,645249,103004
44000,173,16149,7,467851,634369,166518
44000,268,16238,7,564774,656837,92063
44000,251,16109,7,499922,547360,47438
44000,229,16210,7,461348,679659,218311
44000,109,16216,7,507112,579401,72289
44000,195,16202,8,458486,590242,131756
44000,194,16144,7,413968,573758,159790
44000,27,16141,7,451445,620825,169380
44000,128,16096,7,561186,583915,22729
44000,442,16235,8,507445,672204,164759
44000,94,16117,8,412148,596383,184235
44000,363,16263,8,567258,663990,96732
44000,49,16088,7,478926,538104,59178
44000,366,16123,7,628980,680173,51193
44000,25,16139,7,559287,638431,79144
44000,419,16181,7,485872,590446,104574
44000,160,16156,7,658189,785381,127192
44000,551,16144,7,510431,726914,216483
44000,118,16150,7,526603,640508,113905
44000,234,16184,8,488472,742662,254190
44000,327,16107,7,411762,591373,179611
44000,220,16168,7,501077,582749,81672
44000,218,16102,7,504230,723878,219648
44000,168,16129,7,510320,666353,156033
44000,410,16167,10,407589,555364,147775
44000,246,16096,7,430880,573264,142384
44000,244,16202,7,516625,652043,135418
44000,116,16216,8,421846,647245,225399
44000,138,16092,8,528258,617748,89490
44000,38,16163,7,493605,562227,68622
44000,170,16099,9,491125,633777,142652
45000,208,16628,8,502950,629990,127040
45000,274,16581,8,486287,647520,161233
45000,29,16435,7,470339,617214,146875
45000,569,16548,7,521401,745156,223755
45000,227,16521,7,584305,620927,36622
45000,545,16588,8,528102,608252,80150
45000,645,16550,7,437292,648001,210709
45000,123,16440,6,458467,573086,114619
45000,249,16552,7,475349,663386,188037
45000,261,16490,7,478048,601585,123537
45000,140,16654,7,433017,532103,99086
45000,289,16567,8,626713,650676,23963
45000,210,16548,8,484068,744581,260513
45000,82,16607,8,557181,673510,116329
45000,263,16492,7,487951,651269,163318
45000,111,16693,6,570985,573818,2833
45000,158,16571,7,486463,683653,197190
45000,153,16485,7,582505,686604,104099
45000,151,16573,7,509753,580038,70285
45000,311,16519,7,627132,631484,4352
45000,170,16506,8,623727,669674,45947
45000,400,16574,7,455975,677127,221152
45000,263,16645,7,447160,542208,95048
45000,376,16561,8,497597,579647,82050
45000,205,16603,7,440602,572510,131908
45000,34,16457,7,504812,669574,164762
45000,271,16556,8,490079,614126,124047
45000,348,16593,8,467124,587241,120117
45000,162,16591,7,520511,577555,57044
45000,530,16430,7,630405,664553,34148
45000,125,16487,7,465093,608362,143269
45000,272,16608,7,424824,676762,251938
45000,337,16619,7,513595,671499,157904
45000,167,16533,7,451159,622948,171789
45000,263,16593,7,418810,578180,159370
45000,389,16461,7,466732,597723,130991
45000,350,16546,7,518454,556308,37854
45000,379,16524,8,520123,643897,123774
45000,378,16557,8,472950,684058,211108
45000,117,16507,7,453074,678376,225302
45000,178,16549,8,401269,612699,211430
45000,286,16514,7,534501,602161,67660
45000,248,16512,7,452223,617524,165301
45000,247,16495,8,539986,653450,113464
45000,211,16563,7,532083,646504,114421
45000,74,16570,7,433724,597456,163732
45000,157,16656,7,518778,632539,113761
45000,196,16642,7,642762,771616,128854
45000,519,16443,7,532314,605156,72842
45000,112,16511,10,451597,557136,105539
46000,598,16928,7,467767,605188,137421
46000,390,16951,7,505823,578449,72626
46000,328,16964,8,589109,812810,223701
46000,187,16910,7,511224,603182,91958
46000,144,16938,8,557741,677879,120138
46000,237,16950,7,491255,564608,73353
46000,310,16957,7,559456,661566,102110
46000,236,16914,7,503105,622976,119871
46000,209,16840,8,496065,693126,197061
46000,186,16834,7,522227,676754,154527
46000,159,16809,6,551587,629482,77895
46000,611,16900,7,566719,615264,48545
46000,426,17025,7,506641,575490,68849
46000,139,16948,7,495659,765556,269897
46000,397,16921,8,563912,706318,142406
46000,397,16779,7,537576,554403,16827
46000,326,16988,7,604645,666510,61865
46000,323,17068,8,522273,556222,33949
46000,63,16989,8,726682,755543,28861
46000,17,16882,8,493430,601189,107759
46000,365,17014,7,497681,666331,168650
46000,195,16961,7,544565,669808,125243
46000,411,16974,7,449967,658926,208959
46000,335,17021,7,489372,683751,194379
46000,297,16803,7,441074,563054,121980
46000,366,17013,7,608340,705906,97566
46000,257,16950,8,543576,687319,143743
46000,232,16917,8,481737,571185,89448
46000,81,17116,8,499149,620056,120907
46000,387,16875,7,427100,600199,173099
46000,516,17042,7,540363,621980,81617
46000,258,16873,7,627047,822133,195086
46000,321,17009,8,595828,690911,95083
46000,233,16994,7,609178,659352,50174
46000,168,16967,8,543776,687370,143594
46000,89,16965,7,512613,628907,116294
46000,427,16941,7,506225,730433,224208
46000,490,16900,7,525424,679501,154077
46000,117,16880,7,432670,636875,204205
46000,366,16910,7,492120,545137,53017
46000,265,16983,7,551397,586975,35578
46000,306,16857,7,523694,612634,88940
46000,66,16828,7,492368,644849,152481
46000,302,16746,10,489245,790824,301579
46000,460,16864,7,478035,571630,93595
46000,296,16997,7,548699,854586,305887
46000,122,16970,7,519157,669545,150388
46000,283,16984,7,498619,739113,240494
46000,352,16916,7,602535,716091,113556
46000,425,16870,9,508512,645334,136822
47000,288,17395,8,491799,573500,81701
47000,352,17126,8,458904,589708,130804
47000,171,17280,8,475063,682764,207701
47000,182,17336,7,501452,667784,166332
47000,562,17399,9,456019,660392,204373
47000,273,17251,7,710663,715588,4925
47000,174,17329,7,502190,700132,197942
47000,521,17342,8,570904,615195,44291
47000,409,17307,7,529991,728885,198894
47000,406,17175,8,474481,633346,158865
47000,128,17243,7,581955,598709,16754
47000,449,17218,7,599877,695637,95760
47000,463,17069,7,624484,689007,64523
47000,388,17220,7,499978,557218,57240
47000,326,17282,8,567994,749207,181213
47000,324,17223,7,635197,760748,125551
47000,178,17311,8,481663,727405,245742
47000,374,17211,7,624043,701987,77944
47000,228,17297,7,578479,645570,67091
47000,214,17279,8,636933,638281,1348
47000,279,17268,8,463408,627057,163649
47000,208,17301,8,488580,611032,122452
47000,360,17351,7,524358,638456,114098
47000,333,17311,9,468556,620263,151707
47000,125,17255,7,516339,629788,113449
47000,379,17263,7,555161,698157,142996
47000,209,17343,7,535810,700833,165023
47000,277,17215,8,526736,580367,53631
47000,270,17264,7,590141,635282,45141
47000,311,17366,7,546368,626557,80189
47000,134,17332,7,585646,752369,166723
47000,66,17217,7,617710,683099,65389
47000,211,17234,7,517069,657264,140195
47000,367,17233,7,484376,650645,166269
47000,334,17239,8,548457,639793,91336
47000,167,17282,8,520180,643559,123379
47000,141,17337,8,572401,623427,51026
47000,409,17307,7,620437,682678,62241
47000,352,17303,7,485264,630739,145475
47000,60,17341,7,444684,662559,217875
47000,471,17258,7,549034,610477,61443
47000,289,17374,7,568556,626934,58378
47000,62,17334,7,480037,695772,215735
47000,345,17250,7,480451,652766,172315
47000,283,17279,7,487945,598681,110736
47000,306,17264,7,536193,579200,43007
47000,289,17292,7,581859,703812,121953
47000,234,17290,7,626426,666199,39773
47000,311,17318,8,477524,585838,108314
47000,164,17270,7,554543,645631,91088
48000,219,17782,8,583465,750161,166696
48000,295,17555,8,480930,650162,169232
48000,296,17852,7,498482,591778,93296
48000,134,17618,8,604129,684100,79971
48000,435,17628,7,484102,598346,114244
48000,759,17568,7,497881,647710,149829
48000,411,17716,8,532720,657899,125179
48000,122,17716,7,492562,585138,92576
48000,176,17623,7,614251,749666,135415
48000,400,17586,7,515106,702400,187294
48000,319,17835,7,565431,621305,55874
48000,434,17603,8,487732,620684,132952
48000,311,17794,7,645108,655804,10696
48000,261,17663,7,471450,601126,129676
48000,342,17636,7,493095,696100,203005
48000,502,17752,8,636753,712162,75409
48000,90,17643,7,487386,648009,160623
48000,233,17654,7,617790,640241,22451
48000,263,17656,7,498609,808831,310222
48000,344,17611,8,608248,637570,29322
48000,222,17647,7,507550,632497,124947
48000,340,17596,8,582988,684363,101375
48000,293,17586,7,568602,803419,234817
48000,240,17656,8,491199,611293,120094
48000,22,17618,8,597008,678101,81093
48000,309,17571,7,447011,772583,325572
48000,160,17726,7,599887,621044,21157
48000,357,17721,7,501555,623617,122062
48000,261,17716,7,560289,656747,96458
48000,335,17621,8,601524,640649,39125
48000,332,17681,7,472237,581081,108844
48000,199,17666,7,572549,856318,283769
48000,101,17690,10,466873,638687,171814
48000,367,17709,8,424899,676597,251698
48000,105,17726,8,548570,657436,108866
48000,5,17671,7,486453,598672,112219
48000,92,17643,8,602435,604721,2286
48000,161,17652,7,679648,744715,65067
48000,345,17599,6,532945,552069,19124
48000,439,17539,7,571830,688120,116290
48000,307,17691,7,586729,776452,189723
48000,105,17623,9,535362,648398,113036
48000,268,17635,7,550635,652690,102055
48000,279,17726,8,634097,663545,29448
48000,268,17657,8,570930,774587,203657
48000,256,17680,7,497969,588892,90923
48000,281,17676,7,491144,687018,195874
48000,251,17494,7,541310,712136,170826
48000,277,17842,7,590330,750135,159805
48000,288,17728,8,794265,820945,26680
49000,58,18002,8,502809,728909,226100
49000,309,18010,6,500767,781450,280683
49000,536,18002,8,542981,619222,76241
49000,450,17943,6,564541,722578,158037
49000,331,18199,7,733802,790015,56213
49000,100,18005,7,510547,625615,115068
49000,175,17970,8,521269,728546,207277
49000,414,18113,7,507302,649749,142447
49000,353,18025,8,562195,761403,199208
49000,319,18061,7,560252,648128,87876
49000,588,18175,8,641221,680127,38906
49000,144,18056,7,508893,746721,237828
49000,127,17970,8,598269,734202,135933
49000,258,18163,8,492982,625604,132622
49000,356,18016,7,582954,697104,114150
49000,311,18061,8,550953,689958,139005
49000,299,18062,8,533247,791296,258049
49000,366,18003,7,572568,631477,58909
49000,318,18030,7,583688,757840,174152
49000,410,17989,7,445872,658107,212235
49000,226,17918,8,488509,636554,148045
49000,354,17934,8,610440,791348,180908
49000,91,18190,7,642015,694213,52198
49000,111,18031,7,598489,644922,46433
49000,282,18029,9,518106,605568,87462
49000,236,17916,8,523813,604632,80819
49000,348,17948,8,727129,779515,52386
49000,254,17954,8,526721,612715,85994
49000,305,18139,8,536604,797189,260585
49000,534,18095,7,489973,591426,101453
49000,212,18036,7,630212,699566,69354
49000,240,17975,7,496819,815186,318367
49000,308,17932,8,468516,670421,201905
49000,844,17988,7,548737,664729,115992
49000,310,17997,7,517735,745422,227687
49000,394,18068,7,556211,640565,84354
49000,81,18038,7,470354,680886,210532
49000,371,18105,7,610194,693646,83452
49000,127,18070,8,576638,665751,89113
49000,429,17992,7,537704,701414,163710
49000,86,18085,7,504660,688269,183609
49000,256,17951,7,556710,715327,158617
49000,185,18101,8,463096,676235,213139
49000,234,18049,7,622927,683892,60965
49000,380,18046,7,568650,679551,110901
49000,550,18174,7,602460,765248,162788
49000,227,18030,8,570471,675045,104574
49000,47,17968,7,540518,593564,53046
49000,148,17974,7,580273,633891,53618
49000,356,18098,8,483665,628002,144337
50000,518,18364,7,503179,734054,230875
50000,193,18421,8,566581,756368,189787
50000,467,18386,8,565486,687609,122123
50000,438,18381,8,504239,740811,236572
50000,185,18389,8,507779,654373,146594
50000,214,18410,8,494749,768753,274004
50000,150,18361,7,559407,613964,54557
50000,299,18429,7,525352,666137,140785
50000,302,18332,8,562032,662618,100586
50000,366,18394,9,538981,720805,181824
50000,712,18346,8,630122,720363,90241
50000,301,18415,8,669754,706909,37155
50000,144,18469,7,638188,723418,85230
50000,102,18439,8,556090,662243,106153
50000,113,18477,7,611264,633567,22303
50000,402,18301,7,543111,720992,177881
50000,331,18327,8,510024,801313,291289
50000,230,18299,7,583179,718335,135156
50000,128,18354,6,542263,690365,148102
50000,135,18398,8,561846,689614,127768
50000,63,18317,7,500953,640693,139740
50000,328,18391,8,548192,645218,97026
50000,124,18407,7,678663,747292,68629
50000,390,18336,7,580033,644021,63988
50000,435,18377,7,579598,601223,21625
50000,176,18317,7,682463,758172,75709
50000,86,18401,8,618302,743442,125140
50000,80,18389,7,480383,635587,155204
50000,143,18484,8,532695,762103,229408
50000,397,18399,8,553043,718981,165938
50000,402,18486,9,485318,676718,191400
50000,199,18387,7,578059,675582,97523
50000,115,18484,8,600653,861321,260668
50000,635,18501,7,590484,650790,60306
50000,377,18408,8,492123,724852,232729
50000,182,18276,8,453106,657122,204016
50000,298,18395,8,528842,695172,166330
50000,85,18325,7,629277,724215,94938
50000,218,18385,7,561557,671434,109877
50000,137,18432,7,590520,658562,68042
50000,533,18329,8,608949,796438,187489
50000,336,18299,7,515452,726859,211407
50000,452,18349,8,572029,637735,65706
50000,17,18230,7,574099,667977,93878
50000,474,18334,7,624374,663970,39596
50000,217,18366,7,629515,681332,51817
50000,236,18356,7,626073,704406,78333
50000,136,18341,9,499969,715213,215244
50000,202,18404,8,501144,646479,145335
50000,513,18433,7,553860,642475,88615
51000,125,18803,8,585457,743260,157803
51000,312,18641,8,668726,705697,36971
51000,226,18781,7,810606,940170,129564
51000,102,18813,8,604978,757137,152159
51000,326,18854,7,670273,714886,44613
51000,131,18705,7,449822,693141,243319
51000,513,18816,8,601950,661449,59499
51000,349,18842,7,701733,755724,53991
51000,400,18795,6,542945,614593,71648
51000,184,18757,7,496007,775262,279255
51000,269,18770,10,543730,676634,132904
51000,399,18733,8,571890,710946,139056
51000,326,18793,7,552001,1009798,457797
51000,132,18761,7,554655,659810,105155
51000,788,18575,7,591255,664550,73295
51000,386,18688,8,550906,717526,166620
51000,412,18681,6,706597,761473,54876
51000,438,18741,8,636687,724962,88275
51000,48,18768,9,604249,635591,31342
51000,225,18798,7,441961,628585,186624
51000,235,18625,7,633684,723882,90198
51000,241,18840,8,598444,676244,77800
51000,74,18641,7,537044,712873,175829
51000,212,18799,8,503348,823098,319750
51000,622,18778,7,566007,771232,205225
51000,32,18702,8,773787,899592,125805
51000,155,18861,7,539526,814976,275450
51000,188,18716,6,599087,749649,150562
51000,226,18669,7,534177,807389,273212
51000,398,18842,7,525057,802321,277264
51000,308,18861,8,556474,751075,194601
51000,291,18798,7,635903,866782,230879
51000,317,18680,7,637465,807202,169737
51000,448,18687,8,619516,676318,56802
51000,153,18677,7,692500,748864,56364
51000,60,18884,9,544861,843235,298374
51000,301,18819,8,583900,623219,39319
51000,277,18807,8,488528,666495,177967
51000,227,18703,7,558020,715419,157399
51000,83,18753,7,710121,838453,128332
51000,156,18651,7,541035,689922,148887
51000,158,18744,7,610328,778363,168035
51000,173,18742,8,570805,714618,143813
51000,124,18742,7,545832,713916,168084
51000,407,18779,7,540534,750690,210156
51000,111,18795,8,597032,638720,41688
51000,318,18683,7,674688,710270,35582
51000,346,18792,7,577839,625225,47386
51000,420,18753,8,546823,641719,94896
51000,139,18724,8,699158,755690,56532
52000,123,19147,8,672044,698827,26783
52000,182,19093,8,524810,772667,247857
52000,40,19096,6,615020,704037,89017
52000,359,19106,7,606653,709599,102946
52000,295,19116,7,552550,750632,198082
52000,138,19128,8,537786,757171,219385
52000,457,19127,7,633726,741186,107460
52000,363,19187,7,561631,674987,113356
52000,335,19069,8,565434,807836,242402
52000,450,19175,7,599635,665533,65898
52000,275,19173,8,512413,721704,209291
52000,293,19148,8,746933,801482,54549
52000,303,19088,7,553094,872596,319502
52000,472,19123,8,537412,705222,167810
52000,83,19087,8,551897,725186,173289
52000,441,19075,7,595717,713493,117776
52000,201,19226,8,703445,712044,8599
52000,577,19307,8,602962,665183,62221
52000,201,19031,7,571671,702734,131063
52000,418,19066,7,576448,621620,45172
52000,370,19074,7,650905,679105,28200
52000,206,19185,8,509459,712093,202634
52000,485,19020,8,524745,649675,124930
52000,260,19077,6,541230,684002,142772
52000,260,19226,7,568197,644578,76381
52000,27,19003,7,618499,744674,126175
52000,201,19077,8,647397,814474,167077
52000,163,19152,8,574409,899323,324914
52000,492,19178,8,693401,714923,21522
52000,184,19190,9,685772,722252,36480
52000,418,19139,8,633099,705493,72394
52000,352,19131,7,560345,654825,94480
52000,468,19101,7,578467,715248,136781
52000,383,19094,8,650637,738840,88203
52000,380,19088,8,705626,776096,70470
52000,332,19128,7,627979,697114,69135
52000,276,19199,7,539048,780359,241311
52000,356,19119,8,699570,821942,122372
52000,207,19195,7,623983,642543,18560
52000,412,18998,7,563446,653288,89842
52000,277,19115,8,603125,746721,143596
52000,621,19127,7,514654,683796,169142
52000,368,19323,8,684594,718708,34114
52000,621,19209,7,600704,714345,113641
52000,340,19132,8,614475,706885,92410
52000,123,19218,8,561000,777559,216559
52000,468,19055,7,639792,804188,164396
52000,242,19217,7,588031,795720,207689
52000,501,19128,9,683826,742192,58366
52000,514,19067,8,617783,759363,141580
53000,301,19661,9,558535,724582,166047
53000,380,19358,9,603932,749597,145665
53000,265,19551,7,661785,790301,128516
53000,225,19472,7,629019,755815,126796
53000,192,19461,8,566269,743792,177523
53000,230,19536,8,555858,683696,127838
53000,231,19423,7,587148,838033,250885
53000,124,19328,6,572331,912804,340473
53000,277,19514,7,556178,701028,144850
53000,534,19415,7,674042,728949,54907
53000,409,19424,8,535083,644314,109231
53000,561,19457,7,533706,648690,114984
53000,280,19497,9,711235,938598,227363
53000,413,19471,7,607513,888487,280974
53000,198,19536,7,659931,735544,75613
53000,569,19525,7,549063,869824,320761
53000,550,19504,7,696925,777818,80893
53000,174,19505,8,497297,742464,245167
53000,685,19558,8,596522,817890,221368
53000,249,19562,7,539362,776547,237185
53000,390,19540,8,644223,691172,46949
53000,214,19597,8,579765,717681,137916
53000,125,19674,8,642247,705473,63226
53000,320,19463,8,688322,784598,96276
53000,593,19634,7,674611,773215,98604
53000,251,19557,7,764867,828126,63259
53000,197,19516,8,528104,941550,413446
53000,645,19502,8,566704,791806,225102
53000,459,19695,7,530211,632851,102640
53000,102,19552,7,635768,674257,38489
53000,310,19665,8,625132,705435,80303
53000,380,19513,8,664780,898450,233670
53000,193,19616,7,650762,664854,14092
53000,146,19396,7,643388,769150,125762
53000,607,19454,8,720570,868854,148284
53000,179,19430,7,609832,699867,90035
53000,342,19520,8,619940,736850,116910
53000,608,19333,10,665790,803736,137946
53000,147,19581,7,547985,666579,118594
53000,110,19413,7,532997,685965,152968
53000,742,19438,7,562433,773847,211414
53000,144,19449,8,517211,887957,370746
53000,97,19531,7,528936,663399,134463
53000,521,19642,7,682687,790410,107723
53000,163,19431,7,524319,706577,182258
53000,338,19567,8,673123,986274,313151
53000,365,19325,7,614996,805063,190067
53000,438,19478,7,626892,841480,214588
53000,62,19466,8,642681,742611,99930
53000,561,19600,7,606383,721439,115056
54000,222,19815,7,657234,693790,36556
54000,90,19830,7,561884,792763,230879
54000,318,19814,7,514727,823008,308281
54000,359,19788,9,600825,661897,61072
54000,366,19863,7,548279,762749,214470
54000,167,19952,7,544596,739515,194919
54000,456,19925,8,537883,735928,198045
54000,235,19934,8,696770,724290,27520
54000,546,19757,7,592618,705961,113343
54000,115,20007,7,651014,706351,55337
54000,296,19888,7,627177,830641,203464
54000,417,19906,7,582028,1081674,499646
54000,60,19895,7,646784,979841,333057
54000,305,19793,7,709484,756266,46782
54000,149,19798,8,558131,713123,154992
54000,408,19907,8,644933,729449,84516
54000,101,19882,7,581560,674966,93406
54000,506,19841,7,675331,843327,167996
54000,551,20008,7,570444,692359,121915
54000,277,19832,7,674314,849680,175366
54000,385,19816,7,548725,729673,180948
54000,170,19890,7,628846,808776,179930
54000,667,19940,8,647679,760171,112492
54000,212,19760,8,715735,740011,24276
54000,230,19900,7,595019,798924,203905
54000,514,19941,9,564755,883005,318250
54000,185,19848,9,592110,754083,161973
54000,141,19791,9,718690,798680,79990
54000,200,19946,7,727613,789130,61517
54000,190,19910,7,688430,712014,23584
54000,199,19740,8,605305,724095,118790
54000,209,19880,7,638141,662902,24761
54000,893,19814,8,643633,782614,138981
54000,198,19830,8,666623,694366,27743
54000,226,19959,8,623961,717691,93730
54000,306,19727,7,731037,823283,92246
54000,355,19985,9,589067,822730,233663
54000,363,19747,7,614835,737551,122716
54000,236,19845,7,605439,729991,124552
54000,268,19901,8,519284,809189,289905
54000,292,19847,8,680940,816767,135827
54000,168,19838,8,598313,801058,202745
54000,129,19855,7,573690,674020,100330
54000,553,19838,9,579023,705626,126603
54000,306,19931,7,586587,707289,120702
54000,458,19929,7,504413,687072,182659
54000,171,19809,8,530423,669452,139029
54000,645,19724,8,686745,745657,58912
54000,242,19779,8,554992,900681,345689
54000,266,19794,8,893398,912295,18897
55000,137,20147,8,687649,742962,55313
55000,254,20238,8,606264,930719,324455
55000,315,20134,8,775738,834151,58413
55000,242,20116,7,573719,673922,100203
55000,227,20212,8,652572,791563,138991
55000,199,20328,8,618756,740548,121792
55000,397,20246,7,585167,788158,202991
55000,709,20241,7,554287,803467,249180
55000,227,20137,7,580235,761757,181522
55000,290,20217,9,627873,674018,46145
55000,658,20164,8,588392,773361,184969
55000,118,20177,7,641676,772108,130432
55000,491,20240,8,580507,787686,207179
55000,260,20247,7,657887,756876,98989
55000,468,20319,8,564861,735739,170878
55000,175,20289,9,660790,785634,124844
55000,349,20133,8,565902,690168,124266
55000,157,20325,8,673820,737015,63195
55000,112,20151,7,718565,795883,77318
55000,549,20305,8,714969,1057002,342033
55000,261,20309,7,754964,802234,47270
55000,313,20187,7,706647,830162,123515
55000,374,20135,7,528026,673501,145475
55000,496,20304,7,707765,734775,27010
55000,184,20345,9,661698,910401,248703
55000,519,20290,7,617164,807104,189940
55000,120,20215,7,685669,717753,32084
55000,400,20122,7,633906,827537,193631
55000,403,20246,8,618009,742085,124076
55000,104,20273,8,539911,775952,236041
55000,473,20205,7,810659,852722,42063
55000,177,20174,8,543741,1050274,506533
55000,231,20290,9,604232,719018,114786
55000,160,20233,7,560934,786571,225637
55000,32,20176,7,525366,696672,171306
55000,299,20290,7,806155,872165,66010
55000,300,20224,8,532940,779069,246129
55000,204,20381,9,604262,764350,160088
55000,376,20230,7,688198,892072,203874
55000,360,20132,7,748434,785870,37436
55000,212,20152,8,623449,832857,209408
55000,229,20384,7,695314,859931,164617
55000,448,20272,8,655543,747261,91718
55000,347,20265,8,739099,850061,110962
55000,246,20250,8,630246,714668,84422
55000,226,20341,7,632173,847564,215391
55000,306,20258,7,675569,883930,208361
55000,229,20270,7,600547,719704,119157
55000,164,20228,8,670546,986186,315640
55000,156,20261,8,631291,825946,194655
56000,60,20634,8,589832,992126,402294
56000,141,20536,7,618044,828770,210726
56000,231,20606,8,596491,769856,173365
56000,257,20659,7,785693,965829,180136
56000,76,20519,7,680226,846377,166151
56000,328,20713,8,630324,776309,145985
56000,499,20626,8,746210,880191,133981
56000,540,20512,8,785751,950599,164848
56000,611,20491,8,600074,874605,274531
56000,259,20609,8,643611,864764,221153
56000,66,20586,8,681925,750991,69066
56000,154,20527,8,677900,738423,60523
56000,110,20614,7,528191,792055,263864
56000,491,20626,7,668279,757880,89601
56000,696,20688,7,653469,952331,298862
56000,451,20592,7,567184,834907,267723
56000,396,20731,7,915344,928415,13071
56000,273,20590,7,653995,768173,114178
56000,241,20511,7,757673,801324,43651
56000,273,20538,7,572106,718676,146570
56000,157,20589,7,636692,737076,100384
56000,113,20712,7,641549,853631,212082
56000,403,20593,8,790355,922906,132551
56000,256,20572,7,633231,789219,155988
56000,212,20632,8,634555,797954,163399
56000,125,20575,9,691977,746561,54584
56000,266,20662,7,638898,782016,143118
56000,474,20595,8,619635,1055006,435371
56000,226,20649,9,580677,759205,178528
56000,153,20669,7,684938,837135,152197
56000,285,20504,7,645689,828687,182998
56000,566,20548,7,551862,743190,191328
56000,217,20645,9,690697,839865,149168
56000,140,20625,8,585770,761475,175705
56000,89,20621,7,625996,773081,147085
56000,231,20529,7,599367,744651,145284
56000,377,20600,7,575724,746066,170342
56000,371,20635,7,593971,745227,151256
56000,77,20621,8,655383,995193,339810
56000,104,20629,7,584243,716616,132373
56000,720,20642,7,571350,730645,159295
56000,404,20625,8,585406,696088,110682
56000,15,20645,8,644545,682871,38326
56000,597,20581,7,605390,826611,221221
56000,176,20605,7,564066,895986,331920
56000,234,20602,7,659217,714017,54800
56000,107,20660,8,835427,850130,14703
56000,8,20571,8,801016,805354,4338
56000,325,20649,8,568242,843873,275631
56000,319,20675,7,607205,756288,149083
57000,73,20911,8,779418,827963,48545
57000,358,20993,8,615535,819095,203560
57000,222,20955,8,591569,857588,266019
57000,387,21005,8,682991,818798,135807
57000,200,20912,7,826522,844434,17912
57000,447,20966,7,578620,792939,214319
57000,261,20928,7,524014,682637,158623
57000,462,20941,8,707136,902199,195063
57000,251,21058,7,620486,729706,109220
57000,214,20864,7,630349,736881,106532
57000,343,20977,7,667372,818459,151087
57000,424,21015,7,703310,857061,153751
57000,138,20970,8,740095,854542,114447
57000,452,20924,8,572547,776751,204204
57000,196,20994,7,680736,881104,200368
57000,342,21140,8,650414,748738,98324
57000,377,21106,7,618888,746655,127767
57000,551,20986,7,619610,767596,147986
57000,287,21050,9,686673,824848,138175
57000,68,21006,8,730662,924717,194055
57000,179,21036,7,654761,743394,88633
57000,758,20959,7,645656,716424,70768
57000,196,20959,8,840616,849420,8804
57000,323,20967,7,621910,757358,135448
57000,264,21044,7,634735,791766,157031
57000,404,20999,8,796699,820930,24231
57000,381,21023,8,714898,732744,17846
57000,343,20961,8,555455,693773,138318
57000,338,20940,7,570634,796113,225479
57000,596,20950,7,676263,751250,74987
57000,306,20905,7,649889,800652,150763
57000,5,20958,7,579130,803774,224644
57000,360,20962,8,612351,722422,110071
57000,131,20867,7,526613,765085,238472
57000,271,21040,7,656074,883235,227161
57000,281,20907,8,670671,798398,127727
57000,154,20993,7,629001,830613,201612
57000,210,20903,8,642845,832782,189937
57000,319,20959,8,656570,831419,174849
57000,264,20968,8,580612,737156,156544
57000,185,21089,8,629553,809430,179877
57000,265,20941,7,620647,900567,279920
57000,56,20861,7,677980,811374,133394
57000,168,20936,7,738511,1059936,321425
57000,481,20977,8,771616,837655,66039
57000,53,20882,7,663840,823986,160146
57000,128,20983,7,604592,816376,211784
57000,635,20875,8,591234,737479,146245
57000,208,20892,8,751455,784097,32642
57000,305,20946,7,752171,869139,116968
58000,248,21377,7,721720,945134,223414
58000,260,21314,7,644570,772468,127898
58000,208,21298,7,645446,748608,103162
58000,70,21534,8,752384,870366,117982
58000,262,21322,8,682298,847729,165431
58000,528,21360,8,716209,811318,95109
58000,369,21239,7,697641,923767,226126
58000,184,21305,7,757089,828233,71144
58000,368,21335,8,803481,872494,69013
58000,246,21417,7,711387,908409,197022
58000,200,21387,9,666491,903889,237398
58000,291,21413,7,617499,754249,136750
58000,111,21416,8,727144,774098,46954
58000,248,21257,7,718812,921754,202942
58000,136,21372,7,718562,829069,110507
58000,226,21311,7,679844,703424,23580
58000,110,21336,9,613261,795776,182515
58000,420,21340,7,603596,785034,181438
58000,92,21172,7,611618,737425,125807
58000,305,21188,8,604585,743165,138580
58000,204,21424,7,552374,763836,211462
58000,217,21323,7,681462,814322,132860
58000,567,21293,7,660800,801185,140385
58000,139,21298,8,642498,800304,157806
58000,247,21344,8,584804,785717,200913
58000,390,21329,9,595067,731289,136222
58000,178,21208,8,623470,849693,226223
58000,105,21531,7,585209,731873,146664
58000,684,21288,7,710217,804115,93898
58000,194,21376,7,686490,869181,182691
58000,271,21347,7,629983,823258,193275
58000,525,21268,8,672426,751339,78913
58000,436,21368,7,620512,772126,151614
58000,570,21367,7,842591,864229,21638
58000,310,21204,8,663974,793727,129753
58000,306,21337,10,748015,863726,115711
58000,255,21299,7,573403,749279,175876
58000,172,21236,7,577740,696492,118752
58000,622,21335,7,692409,806832,114423
58000,165,21309,9,612715,746567,133852
58000,280,21340,7,696067,914067,218000
58000,423,21268,9,626786,706009,79223
58000,205,21335,7,579318,727063,147745
58000,258,21447,8,639971,865995,226024
58000,135,21221,9,692387,932303,239916
58000,212,21277,7,585537,948814,363277
58000,309,21319,7,725593,910959,185366
58000,444,21533,7,738235,815851,77616
58000,126,21378,7,691000,843586,152586
58000,190,21354,7,662131,951593,289462
59000,499,21896,8,598027,880083,282056
59000,698,21663,7,640777,880612,239835
59000,68,21710,8,658603,758707,100104
59000,462,21807,8,690379,738798,48419
59000,425,21773,8,705431,774044,68613
59000,306,21706,7,724242,820614,96372
59000,390,21729,7,652160,809414,157254
59000,415,21709,7,602361,900278,297917
59000,512,21711,7,798216,1031024,232808
59000,281,21662,7,675283,854077,178794
59000,285,21764,7,822456,919133,96677
59000,347,21880,9,595403,837245,241842
59000,225,21709,7,665803,848300,182497
59000,137,21731,7,674531,816449,141918
59000,116,21704,8,916482,989274,72792
59000,118,21720,7,883559,1053228,169669
59000,265,21769,7,685136,1016024,330888
59000,217,21708,8,566394,845470,279076
59000,88,21668,7,821787,859384,37597
59000,68,21802,8,646109,825231,179122
59000,290,21723,7,592656,891577,298921
59000,318,21759,8,791955,842160,50205
59000,240,21616,8,582611,867231,284620
59000,267,21668,7,769338,950558,181220
59000,120,21885,7,657363,759683,102320
59000,375,21735,7,640088,800139,160051
59000,307,21809,7,662988,793436,130448
59000,197,21612,7,660916,837530,176614
59000,201,21567,8,617136,854198,237062
59000,514,21705,8,685106,985859,300753
59000,334,21743,7,686792,729294,42502
59000,174,21705,7,827457,898724,71267
59000,99,21535,7,625666,779500,153834
59000,39,21694,7,717543,872001,154458
59000,315,21622,7,609501,767022,157521
59000,321,21744,7,690390,907935,217545
59000,127,21710,7,715661,793649,77988
59000,277,21796,8,739938,1136706,396768
59000,752,21645,7,707305,808167,100862
59000,474,21649,7,545207,770686,225479
59000,574,21699,9,628541,890073,261532
59000,397,21750,8,621287,764758,143471
59000,332,21769,7,627481,835709,208228
59000,323,21575,7,619863,992811,372948
59000,568,21773,7,791105,970087,178982
59000,305,21634,7,735912,887595,151683
59000,492,21793,8,633156,731784,98628
59000,350,21667,7,675261,931707,256446
59000,389,21748,7,630604,835122,204518
59000,518,21680,9,614501,879110,264609
60000,152,21997,7,658921,749465,90544
60000,249,22160,9,680767,844497,163730
60000,567,22030,8,706983,849066,142083
60000,314,22102,7,628651,927122,298471
60000,353,22139,8,650605,842084,191479
60000,229,21960,7,684983,919449,234466
60000,556,22134,9,690209,850345,160136
60000,118,22236,7,606571,793668,187097
60000,152,22109,8,594444,863218,268774
60000,326,22043,7,679717,796546,116829
60000,499,22002,7,609980,892520,282540
60000,254,22162,8,867844,933593,65749
60000,219,22306,7,716647,809627,92980
60000,118,22112,7,696148,961272,265124
60000,77,22069,8,558925,849545,290620
60000,760,22109,8,619867,826140,206273
60000,457,21922,8,609002,768170,159168
60000,118,22061,7,579367,814368,235001
60000,130,22064,7,642580,857226,214646
60000,165,22096,8,694047,857742,163695
60000,218,21973,7,739784,872172,132388
60000,289,21911,7,600115,714732,114617
60000,147,22154,7,615740,815631,199891
60000,148,22129,7,700145,818122,117977
60000,397,22010,8,662245,824328,162083
60000,434,22063,8,678762,1011792,333030
60000,522,21996,8,686436,885032,198596
60000,377,21991,7,628274,774926,146652
60000,354,21999,8,853351,1131517,278166
60000,195,22069,7,637539,845518,207979
60000,180,21993,7,660963,768912,107949
60000,325,22069,7,811636,893471,81835
60000,673,22059,8,758483,801660,43177
60000,266,21956,8,637179,852588,215409
60000,212,22070,9,689587,803814,114227
60000,97,21993,7,833750,889509,55759
60000,378,22114,7,689360,840055,150695
60000,356,22217,8,696152,740774,44622
60000,451,21959,8,831701,913756,82055
60000,103,22067,7,726335,789822,63487
60000,420,22188,7,589946,1000784,410838
60000,551,22190,7,615260,785359,170099
60000,136,22097,7,735067,802093,67026
60000,255,22275,8,730774,818600,87826
60000,332,22087,7,780693,802753,22060
60000,185,22077,7,630288,869095,238807
60000,426,22044,9,616838,797959,181121
60000,270,22067,7,665556,773977,108421
60000,351,22153,8,823424,860185,36761
60000,497,22075,7,679462,873447,193985
61000,660,22569,7,623498,922860,299362
61000,561,22340,7,685223,834169,148946
61000,122,22510,8,683008,818952,135944
61000,185,22374,8,613344,826810,213466
61000,182,22401,8,712399,901879,189480
61000,212,22519,8,674471,879778,205307
61000,314,22516,7,706377,935913,229536
61000,146,22448,8,666411,909471,243060
61000,492,22335,8,703198,782057,78859
61000,340,22646,7,732918,853850,120932
61000,288,22392,8,668612,906214,237602
61000,380,22455,7,834724,951955,117231
61000,267,22413,9,694850,869440,174590
61000,172,22307,8,706117,910058,203941
61000,613,22425,7,674714,785178,110464
61000,222,22384,7,654800,874360,219560
61000,195,22490,8,735468,754595,19127
61000,437,22403,7,705999,844551,138552
61000,205,22501,7,691730,843345,151615
61000,308,22507,8,713398,831206,117808
61000,102,22459,7,642079,803350,161271
61000,271,22492,7,670677,974961,304284
61000,104,22489,7,786184,847028,60844
61000,213,22254,7,715526,895351,179825
61000,376,22512,8,635290,842700,207410
61000,390,22371,7,661391,823119,161728
61000,171,22410,8,649445,823361,173916
61000,372,22426,8,605511,827521,222010
61000,239,22298,8,655535,827149,171614
61000,328,22496,8,802030,921164,119134
61000,376,22417,7,784825,981040,196215
61000,184,22488,8,702141,766833,64692
61000,185,22407,7,793801,1037340,243539
61000,475,22496,7,814477,1002170,187693
61000,186,22381,8,703437,770115,66678
61000,322,22401,7,869702,931103,61401
61000,319,22529,9,632111,1189938,557827
61000,148,22402,9,641166,786622,145456
61000,326,22367,7,734301,788105,53804
61000,361,22533,7,794707,817907,23200
61000,254,22607,8,660601,781824,121223
61000,114,22456,8,636628,836590,199962
61000,489,22421,8,704195,755643,51448
61000,111,22523,7,695691,769230,73539
61000,409,22428,7,749367,879049,129682
61000,397,22500,7,595069,761899,166830
61000,473,22468,7,591929,872463,280534
61000,161,22396,7,689864,938209,248345
61000,136,22474,7,691280,866679,175399
61000,245,22364,8,694182,830342,136160
62000,220,22826,8,755902,880952,125050
62000,78,22815,8,820733,955269,134536
62000,433,22674,8,830335,881779,51444
62000,221,22825,8,666300,829602,163302
62000,176,22811,8,738353,1000947,262594
62000,398,22761,7,633561,808446,174885
62000,750,22766,7,642434,813120,170686
62000,198,22985,7,824260,851928,27668
62000,373,22917,7,712890,1017748,304858
62000,416,22754,7,772321,1024992,252671
62000,578,22861,8,681098,810184,129086
62000,581,22772,7,750459,862111,111652
62000,161,22679,7,677644,975999,298355
62000,104,22896,8,596872,812958,216086
62000,251,22816,8,697819,840537,142718
62000,141,22866,7,589771,1005289,415518
62000,117,22690,8,806859,853721,46862
62000,125,22739,8,671242,1041152,369910
62000,66,22818,7,718985,883889,164904
62000,466,22739,7,613372,819599,206227
62000,409,22812,8,736619,848562,111943
62000,102,22743,8,704019,894868,190849
62000,566,22776,9,714060,833391,119331
62000,560,22683,8,783134,875277,92143
62000,549,22890,7,736026,1029169,293143
62000,424,22782,7,786228,787270,1042
62000,251,22997,7,681179,802436,121257
62000,213,22911,7,776293,781865,5572
62000,247,22888,7,752431,970266,217835
62000,489,22853,7,642167,841715,199548
62000,144,22792,7,799557,887226,87669
62000,108,22847,8,649029,863843,214814
62000,424,22756,8,737001,856372,119371
62000,294,22712,7,727441,808096,80655
62000,299,22766,6,753330,813942,60612
62000,208,22812,7,760930,869078,108148
62000,265,22778,7,678177,877714,199537
62000,76,22762,7,853664,960676,107012
62000,148,22720,7,742513,917137,174624
62000,372,22690,8,651159,851279,200120
62000,394,22960,7,767684,810768,43084
62000,514,22754,7,676311,805727,129416
62000,278,22814,7,684269,999237,314968
62000,434,22834,7,826609,970415,143806
62000,245,22935,8,652675,901310,248635
62000,108,22596,7,623107,782335,159228
62000,389,22830,8,612641,796599,183958
62000,586,22777,7,632542,807631,175089
62000,318,22856,8,778933,919551,140618
62000,420,22844,8,636090,914496,278406
63000,214,23148,8,718342,908798,190456
63000,368,23138,8,702793,807497,104704
63000,271,23103,7,753198,835743,82545
63000,186,23094,7,831900,1043563,211663
63000,70,23066,7,637260,802047,164787
63000,240,23101,7,757312,957897,200585
63000,355,23160,7,714314,998929,284615
63000,124,23189,7,616047,882789,266742
63000,359,23148,7,704976,872590,167614
63000,576,23139,7,696627,897548,200921
63000,54,22920,7,891094,929456,38362
63000,442,23289,7,798407,861161,62754
63000,173,23077,8,790003,906926,116923
63000,277,23182,8,770264,931286,161022
63000,281,23124,8,808983,911429,102446
63000,68,23116,8,687980,802301,114321
63000,414,23141,7,620779,759645,138866
63000,221,23147,7,658247,870007,211760
63000,240,23220,7,643874,821764,177890
63000,173,23175,7,748789,817772,68983
63000,559,23078,8,798753,990796,192043
63000,78,23253,8,898541,959894,61353
63000,183,23142,8,697511,947008,249497
63000,320,23235,8,771224,847954,76730
63000,123,23192,7,688275,966032,277757
63000,577,23144,7,842544,947027,104483
63000,312,23171,8,700068,982914,282846
63000,486,23145,7,674762,834366,159604
63000,95,23234,7,650525,1008038,357513
63000,737,23195,7,790232,880745,90513
63000,269,23236,7,661631,994394,332763
63000,33,23236,7,686476,1057255,370779
63000,384,23172,7,637550,848644,211094
63000,547,23170,7,715301,769430,54129
63000,377,23121,6,772018,899394,127376
63000,431,23227,8,876322,1085261,208939
63000,170,23152,8,1051053,1153849,102796
63000,334,23188,7,624692,932004,307312
63000,119,23325,8,764000,797404,33404
63000,359,23109,7,714711,864723,150012
63000,385,23190,7,805209,998733,193524
63000,116,23188,10,610801,876802,266001
63000,229,23266,7,686630,1087833,401203
63000,325,23094,7,848672,937073,88401
63000,487,23222,7,651355,856047,204692
63000,359,23156,7,704845,1060526,355681
63000,322,23159,7,743162,973280,230118
63000,194,23142,7,652330,907758,255428
63000,307,23144,7,572375,790711,218336
63000,127,23228,8,698591,919708,221117
64000,512,23439,8,639760,869218,229458
64000,326,23513,7,670762,840018,169256
64000,335,23499,7,907333,1106012,198679
64000,618,23541,8,772224,889449,117225
64000,116,23579,8,695898,886025,190127
64000,454,23422,7,680585,872983,192398
64000,139,23532,8,717644,885096,167452
64000,533,23605,7,770515,891482,120967
64000,85,23394,8,665511,1069528,404017
64000,373,23480,7,685074,890482,205408
64000,116,23639,8,823267,930299,107032
64000,528,23575,7,664177,901790,237613
64000,205,23624,8,767393,869282,101889
64000,10,23566,9,849103,909503,60400
64000,250,23558,7,739276,835619,96343
64000,443,23416,7,630429,910547,280118
64000,284,23449,7,735622,782051,46429
64000,356,23508,7,790818,957469,166651
64000,326,23539,7,672836,857251,184415
64000,211,23519,9,667213,952936,285723
64000,289,23554,7,881763,1017383,135620
64000,548,23591,7,989006,1005553,16547
64000,483,23491,8,896371,908652,12281
64000,472,23549,8,717813,876956,159143
64000,267,23627,8,757036,826603,69567
64000,216,23625,7,639351,794035,154684
64000,397,23499,7,640560,799946,159386
64000,438,23681,8,875413,999937,124524
64000,353,23503,8,647236,943861,296625
64000,343,23580,7,716250,1142962,426712
64000,115,23594,7,701495,812962,111467
64000,356,23536,9,688596,851736,163140
64000,118,23500,9,645606,902081,256475
64000,46,23534,8,662803,905187,242384
64000,326,23458,7,819848,915757,95909
64000,58,23627,7,715665,957721,242056
64000,148,23482,7,685248,855155,169907
64000,273,23738,7,689348,878309,188961
64000,164,23638,7,1111920,1214773,102853
64000,478,23486,7,773205,883942,110737
64000,395,23639,7,663225,927476,264251
64000,287,23561,7,739389,912927,173538
64000,181,23524,7,747077,1065743,318666
64000,145,23670,7,767576,844066,76490
64000,457,23520,7,777884,942469,164585
64000,698,23543,8,874757,1046143,171386
64000,247,23454,8,651775,867750,215975
64000,442,23631,7,592505,1118038,525533
64000,919,23582,7,691699,991576,299877
64000,401,23493,8,839329,923848,84519
65000,505,23832,8,735875,850563,114688
65000,103,24034,8,807476,894168,86692
65000,342,23948,7,758231,997672,239441
65000,322,24033,9,786448,954672,168224
65000,273,23893,7,758680,1099932,341252
65000,380,24002,8,769293,829483,60190
65000,113,23895,7,679843,1028527,348684
65000,481,23857,7,1040547,1151442,110895
65000,228,23994,7,758680,1043731,285051
65000,354,23877,7,793157,978478,185321
65000,412,23916,8,697930,849987,152057
65000,258,23875,9,729405,984201,254796
65000,33,24044,8,815180,1029599,214419
65000,557,23978,7,788170,1048742,260572
65000,655,23896,7,741485,915111,173626
65000,290,23824,9,688498,912197,223699
65000,95,23958,9,790065,919279,129214
65000,182,23801,7,739704,911867,172163
65000,508,23876,8,894109,1181136,287027
65000,251,23943,8,639406,875136,235730
65000,380,23855,8,744493,1068220,323727
65000,548,23879,7,782351,804992,22641
65000,680,23985,8,724050,1079503,355453
65000,135,23976,7,674866,1071831,396965
65000,343,23915,7,832568,936581,104013
65000,209,23854,7,715161,1140839,425678
65000,493,23893,8,694746,943966,249220
65000,288,23935,7,738372,877192,138820
65000,97,23868,7,629814,919010,289196
65000,277,24038,7,650816,903949,253133
65000,269,23831,8,661147,798830,137683
65000,744,23956,8,701263,1080471,379208
65000,282,23921,9,832454,961136,128682
65000,312,23824,8,692118,1037186,345068
65000,301,23903,7,728926,1036419,307493
65000,229,24006,7,649624,948443,298819
65000,378,23753,7,657293,906423,249130
65000,446,23866,7,673510,870426,196916
65000,403,23955,7,790499,1030715,240216
65000,200,23915,7,928281,954305,26024
65000,435,23911,9,653593,836622,183029
65000,270,23880,8,751056,932138,181082
65000,181,23921,7,783837,990625,206788
65000,105,23831,7,757432,976103,218671
65000,548,23994,8,796590,1007462,210872
65000,151,23858,10,772605,910240,137635
65000,145,23927,8,699131,772327,73196
65000,64,24026,9,780165,886443,106278
65000,189,23772,8,648112,870979,222867
65000,174,23826,7,746364,989142,242778
66000,297,24217,7,722902,810382,87480
66000,244,24217,7,736748,960638,223890
66000,547,24136,7,879406,1038536,159130
66000,203,24306,7,717368,861772,144404
66000,215,24449,8,725190,861554,136364
66000,230,24219,7,835742,941402,105660
66000,486,24258,8,728948,862793,133845
66000,335,24275,7,786095,867193,81098
66000,512,24208,8,825517,885966,60449
66000,167,24262,7,798046,949311,151265
66000,258,24234,7,680476,1011779,331303
66000,466,24051,8,713454,961153,247699
66000,171,24305,8,829795,933537,103742
66000,326,24297,7,742955,839915,96960
66000,396,24201,7,716879,863435,146556
66000,273,24387,8,820736,1008759,188023
66000,143,24397,7,732487,880269,147782
66000,138,24225,7,684914,782734,97820
66000,189,24382,8,868809,946086,77277
66000,18,24210,8,898572,962633,64061
66000,588,24251,7,754313,981971,227658
66000,563,24215,8,673156,956023,282867
66000,38,24123,7,738613,1031728,293115
66000,384,24291,7,715153,1006007,290854
66000,278,24301,8,787968,947021,159053
66000,334,24346,8,734486,834422,99936
66000,275,24311,8,711963,1040923,328960
66000,308,24233,8,789497,907044,117547
66000,138,24233,8,707667,847101,139434
66000,232,24395,8,764707,939124,174417
66000,639,24188,7,745208,851438,106230
66000,51,24229,7,758675,917696,159021
66000,86,24286,8,872061,1165976,293915
66000,304,24236,7,619695,1009949,390254
66000,731,24225,9,717863,998702,280839
66000,439,24328,7,858213,1077953,219740
66000,299,24268,9,811585,850295,38710
66000,247,24177,7,764592,919155,154563
66000,504,24305,8,704787,901114,196327
66000,247,24244,7,701560,946261,244701
66000,848,24166,8,758511,885524,127013
66000,437,24315,7,702630,889717,187087
66000,685,24318,8,905421,1069841,164420
66000,299,24132,7,713355,914930,201575
66000,456,24265,7,702571,922351,219780
66000,20,24366,7,667718,874343,206625
66000,67,24267,7,836745,954476,117731
66000,153,24219,7,915169,1039967,124798
66000,445,24279,8,785829,927780,141951
66000,472,24421,7,788026,1027878,239852
67000,381,24655,8,773839,892485,118646
67000,292,24682,7,841734,882863,41129
67000,617,24648,7,672955,880086,207131
67000,157,24662,7,835217,1031791,196574
67000,378,24617,7,726270,816382,90112
67000,159,24729,8,995689,1019331,23642
67000,321,24661,8,830081,1007996,177915
67000,508,24485,7,932170,971092,38922
67000,519,24601,7,802843,927273,124430
67000,198,24654,8,778845,931723,152878
67000,103,24535,7,806587,1131254,324667
67000,261,24685,8,831449,896634,65185
67000,572,24794,8,784891,1040020,255129
67000,446,24680,7,857915,1036152,178237
67000,154,24535,8,755205,883127,127922
67000,224,24593,8,700359,864627,164268
67000,136,24594,7,733957,832187,98230
67000,398,24714,7,778895,988447,209552
67000,458,24708,7,796124,1217426,421302
67000,381,24837,7,775768,875448,99680
67000,219,24670,7,714542,1120952,406410
67000,303,24504,8,783619,1071983,288364
67000,420,24525,7,665363,919087,253724
67000,668,24718,7,707851,956029,248178
67000,435,24728,7,829287,859392,30105
67000,463,24531,8,766769,987797,221028
67000,179,24722,7,729820,956207,226387
67000,267,24677,9,775933,996210,220277
67000,302,24622,7,739980,923550,183570
67000,596,24711,8,739030,931258,192228
67000,414,24675,7,803748,869808,66060
67000,413,24533,8,691043,917569,226526
67000,614,24673,9,734976,888862,153886
67000,415,24567,7,757181,936369,179188
67000,314,24597,6,829561,1341991,512430
67000,411,24548,7,962510,1088284,125774
67000,295,24749,7,696499,951886,255387
67000,408,24622,8,822969,970814,147845
67000,447,24632,7,755413,1132398,376985
67000,548,24650,8,801966,848808,46842
67000,452,24586,8,828682,936046,107364
67000,467,24576,7,1230006,1232023,2017
67000,601,24639,6,686556,913839,227283
67000,289,24642,7,770312,931574,161262
67000,147,24696,8,744572,885576,141004
67000,476,24490,9,769376,1010712,241336
67000,217,24542,7,881495,920314,38819
67000,332,24562,7,686543,874407,187864
67000,441,24531,7,731314,1012673,281359
67000,131,24590,7,632191,882647,250456
68000,415,24968,7,798929,832141,33212
68000,279,25104,7,724461,983852,259391
68000,132,25008,7,825703,1086260,260557
68000,331,25049,8,964512,1143885,179373
68000,392,24999,8,791645,926653,135008
68000,135,25095,8,966281,1104268,137987
68000,138,24888,7,801603,996843,195240
68000,201,24965,9,722263,868726,146463
68000,380,24995,7,696411,1224962,528551
68000,378,25118,7,706370,1222449,516079
68000,262,25046,7,1007679,1062890,55211
68000,176,25134,9,792776,968767,175991
68000,282,25215,8,717060,1149286,432226
68000,697,25030,7,801206,874690,73484
68000,161,24960,7,778682,910529,131847
68000,479,25072,8,717780,843560,125780
68000,304,24988,7,917989,926073,8084
68000,159,25115,8,776953,1114785,337832
68000,387,24987,8,802742,907273,104531
68000,362,24914,8,765093,979308,214215
68000,267,25116,8,1003680,1018328,14648
68000,149,24959,8,855046,1136866,281820
68000,175,24924,7,811784,919319,107535
68000,576,25090,7,1018943,1025022,6079
68000,556,24927,7,773459,1013455,239996
68000,447,25139,7,695724,870272,174548
68000,230,24952,8,770612,907187,136575
68000,103,25128,8,837352,905473,68121
68000,351,24929,9,1012987,1146019,133032
68000,336,25039,8,856803,942218,85415
68000,688,25103,8,815951,945387,129436
68000,449,24935,7,800838,975023,174185
68000,396,25003,8,758327,1076554,318227
68000,582,25052,7,793621,969037,175416
68000,451,25035,7,958516,993696,35180
68000,592,25020,8,934146,1031523,97377
68000,334,24873,8,790091,1032984,242893
68000,370,25006,7,793318,960217,166899
68000,432,25069,8,879521,966518,86997
68000,343,25033,8,796260,1061958,265698
68000,295,24989,8,710356,952361,242005
68000,265,24959,8,734746,872952,138206
68000,145,25050,7,892621,1008653,116032
68000,77,25181,8,819374,919173,99799
68000,258,25083,7,779373,898017,118644
68000,430,25137,8,837864,893793,55929
68000,471,25112,7,866943,954997,88054
68000,111,24896,7,747976,995453,247477
68000,789,25015,8,782523,875779,93256
68000,264,24998,7,704640,1059697,355057
69000,185,25408,10,753154,1023056,269902
69000,111,25597,8,832337,852331,19994
69000,96,25444,7,1235445,1329284,93839
69000,450,25298,7,838917,1074807,235890
69000,327,25479,8,833647,1053174,219527
69000,324,25377,7,820637,865991,45354
69000,275,25367,7,830859,1013091,182232
69000,441,25230,7,845781,891517,45736
69000,619,25286,8,730325,936781,206456
69000,270,25384,8,894095,982008,87913
69000,341,25456,8,749644,997854,248210
69000,406,25564,8,670503,893247,222744
69000,555,25447,8,694116,1013898,319782
69000,74,25411,8,755653,943242,187589
69000,476,25471,8,976533,1054442,77909
69000,480,25536,9,914586,965851,51265
69000,88,25407,7,926108,972471,46363
69000,305,25421,7,979412,1010405,30993
69000,508,25346,8,980476,996443,15967
69000,561,25399,7,846059,887279,41220
69000,329,25365,8,719238,920843,201605
69000,834,25375,8,736439,965259,228820
69000,437,25311,8,793692,979861,186169
69000,276,25398,7,834145,1014510,180365
69000,200,25532,9,932975,1079512,146537
69000,335,25388,7,811873,1100559,288686
69000,281,25267,8,757480,870517,113037
69000,818,25509,7,904229,1095192,190963
69000,557,25435,7,801782,872848,71066
69000,489,25502,8,694323,900111,205788
69000,107,25512,8,762129,1065753,303624
69000,351,25351,8,752692,956954,204262
69000,478,25489,9,693867,925084,231217
69000,342,25343,7,795395,1001288,205893
69000,665,25366,7,743594,921257,177663
69000,551,25404,7,845232,1077200,231968
69000,345,25592,7,687026,814596,127570
69000,209,25278,8,857712,1049531,191819
69000,135,25385,7,787701,955982,168281
69000,224,25408,7,744858,967854,222996
69000,183,25286,7,705072,907548,202476
69000,281,25304,7,799268,969191,169923
69000,641,25339,7,775418,981451,206033
69000,932,25506,7,831307,1020775,189468
69000,635,25315,8,771841,929505,157664
69000,182,25467,9,878750,997050,118300
69000,910,25316,7,784543,1023252,238709
69000,223,25368,7,811575,930585,119010
69000,196,25355,8,869876,991868,121992
69000,212,25479,8,707871,902466,194595
70000,176,25712,8,1004773,1112219,107446
70000,277,25711,8,752522,882051,129529
70000,162,25807,7,771781,924055,152274
70000,445,25666,7,702838,1081601,378763
70000,279,25808,8,914918,972574,57656
70000,456,25722,8,853083,1032731,179648
70000,416,25747,7,824005,893152,69147
70000,414,25713,7,872688,981278,108590
70000,399,25790,7,885553,1060298,174745
70000,306,25729,7,840249,1037829,197580
70000,320,25733,9,813193,1073277,260084
70000,71,25735,8,856814,916644,59830
70000,533,25642,8,694418,866850,172432
70000,365,25627,9,733711,894329,160618
70000,39,25613,7,1094409,1180738,86329
70000,558,25767,7,832532,1089403,256871
70000,492,25909,8,937812,1177618,239806
70000,203,25772,7,809074,945009,135935
70000,153,25876,7,799757,1091540,291783
70000,334,25740,7,1143911,1186948,43037
70000,166,25701,7,720241,927995,207754
70000,364,25769,7,841816,956621,114805
70000,296,25736,9,824268,959851,135583
70000,423,25703,8,859736,1107350,247614
70000,487,25775,7,791464,958856,167392
70000,92,25758,8,775755,899893,124138
70000,521,25726,7,787082,837030,49948
70000,301,25769,7,796694,1015681,218987
70000,545,25782,7,756885,1079733,322848
70000,278,25946,7,665023,936780,271757
70000,351,25844,7,881965,1011253,129288
70000,465,25672,8,757026,957964,200938
70000,403,25840,7,838681,1016201,177520
70000,312,25860,7,839632,994129,154497
70000,460,25628,8,793547,928875,135328
70000,239,25850,7,1035534,1331966,296432
70000,316,25907,7,969303,981272,11969
70000,118,25764,8,936104,1016852,80748
70000,259,25837,9,765549,935166,169617
70000,432,25859,8,920546,1013705,93159
70000,115,25667,8,801900,938454,136554
70000,466,25748,10,867624,1041998,174374
70000,149,25639,6,687128,1044731,357603
70000,730,25741,8,795389,950886,155497
70000,181,25906,8,691443,942214,250771
70000,338,25664,7,796596,905665,109069
70000,883,25738,8,829714,936385,106671
70000,64,25607,7,920571,1057029,136458
70000,331,25838,7,914489,1001121,86632
70000,279,25858,8,754544,981998,227454
71000,650,26073,7,762238,913462,151224
71000,172,25920,7,796091,996366,200275
71000,684,26104,8,722580,959962,237382
71000,490,26103,8,899781,1080327,180546
71000,430,26129,7,942778,995290,52512
71000,408,26081,7,757153,964763,207610
71000,9,26078,7,794778,1165872,371094
71000,285,26108,8,758592,1038566,279974
71000,100,26137,7,751385,971783,220398
71000,85,26070,7,889896,962479,72583
71000,313,25999,9,781069,958355,177286
71000,571,26165,10,877385,1082345,204960
71000,537,26052,7,823625,1115470,291845
71000,304,26197,9,811501,1011380,199879
71000,376,26157,8,785431,930388,144957
71000,170,25948,8,881038,951378,70340
71000,70,26031,8,877898,946359,68461
71000,370,26049,7,880839,1016096,135257
71000,410,26131,8,1084742,1089899,5157
71000,356,26135,8,825523,1250690,425167
71000,136,26221,7,797532,1291603,494071
71000,275,26263,7,805085,1036694,231609
71000,512,26138,7,909354,999290,89936
71000,174,26156,7,847008,1034138,187130
71000,96,26157,8,758099,1079584,321485
71000,503,25962,7,801148,1017659,216511
71000,188,26050,7,747919,1030566,282647
71000,368,25993,7,795702,987548,191846
71000,132,26181,8,803814,955965,152151
71000,108,26092,7,876495,1055902,179407
71000,233,26194,7,850477,1146407,295930
71000,84,26109,8,849250,982657,133407
71000,524,26008,8,785630,1045108,259478
71000,277,26165,7,788842,923879,135037
71000,234,26015,8,860902,1193516,332614
71000,121,26143,7,759814,1060710,300896
71000,193,26059,7,762202,1138452,376250
71000,385,26130,8,794305,984651,190346
71000,292,25966,8,825723,906609,80886
71000,239,26238,8,848053,1171326,323273
71000,41,26126,7,839306,1018033,178727
71000,133,26146,7,1132092,1483617,351525
71000,148,26239,7,846999,943513,96514
71000,613,26169,8,856535,987661,131126
71000,135,26127,8,913943,971819,57876
71000,576,26252,7,765577,943887,178310
71000,352,26346,7,774756,908847,134091
71000,341,26123,7,709471,959075,249604
71000,431,26189,7,816832,992346,175514
71000,736,26117,9,952419,1024695,72276
72000,95,26426,7,743467,1151597,408130
72000,223,26527,8,1131112,1159594,28482
72000,256,26467,7,845417,1121777,276360
72000,383,26535,7,772699,978853,206154
72000,36,26571,8,665889,908432,242543
72000,666,26361,8,946565,1089019,142454
72000,169,26444,7,915075,1011586,96511
72000,339,26524,8,1208845,1229272,20427
72000,249,26451,8,806628,1077548,270920
72000,399,26327,10,862308,985045,122737
72000,421,26521,7,828848,1095970,267122
72000,373,26521,8,928788,947617,18829
72000,304,26477,9,882696,1103020,220324
72000,175,26450,7,881928,1041823,159895
72000,281,26527,8,751881,1026601,274720
72000,368,26426,7,1072257,1123293,51036
72000,124,26505,7,876975,1085565,208590
72000,681,26476,8,958876,1050239,91363
72000,240,26426,8,789497,940049,150552
72000,283,26532,7,810046,1029200,219154
72000,704,26359,7,775423,963623,188200
72000,305,26477,7,868015,1041349,173334
72000,417,26518,8,943980,1202310,258330
72000,603,26454,7,845289,950542,105253
72000,501,26503,8,766357,883257,116900
72000,225,26326,8,947093,1065564,118471
72000,333,26557,7,814658,1078250,263592
72000,153,26543,7,812952,1313722,500770
72000,301,26501,7,731936,1107574,375638
72000,330,26502,7,888361,993372,105011
72000,153,26424,8,810551,1026254,215703
72000,784,26580,7,973016,1062196,89180
72000,134,26591,7,788900,896047,107147
72000,466,26556,7,770578,996142,225564
72000,381,26502,7,831114,1063811,232697
72000,637,26600,7,811542,1246470,434928
72000,710,26491,9,983040,1075419,92379
72000,235,26503,7,892733,1141646,248913
72000,153,26405,8,793119,1064534,271415
72000,330,26492,7,701736,959400,257664
72000,305,26614,8,804097,1032335,228238
72000,429,26549,8,807547,955147,147600
72000,233,26654,8,920801,1024463,103662
72000,215,26522,7,759464,977911,218447
72000,404,26483,7,875986,900915,24929
72000,293,26618,8,830140,994164,164024
72000,558,26478,8,1060034,1085384,25350
72000,448,26495,9,771194,939151,167957
72000,163,26490,8,864460,1046324,181864
72000,386,26286,7,755890,1197395,441505
73000,92,26883,8,951194,1168524,217330
73000,580,26823,7,846682,983380,136698
73000,517,26827,7,901290,1051255,149965
73000,460,27012,7,830872,999124,168252
73000,364,26819,8,788473,874135,85662
73000,241,26666,7,858654,992757,134103
73000,452,26900,7,782421,1083246,300825
73000,643,26675,7,1139049,1145229,6180
73000,89,26824,7,912628,975940,63312
73000,280,26732,8,855879,1140001,284122
73000,571,26809,8,784221,931239,147018
73000,347,26773,8,812467,1101581,289114
73000,77,26738,8,754012,941100,187088
73000,658,26794,8,873248,937477,64229
73000,168,26696,9,724211,925439,201228
73000,240,26985,8,867169,1041657,174488
73000,420,26972,7,786240,1026453,240213
73000,539,26910,7,737665,988640,250975
73000,84,26906,7,818136,1137410,319274
73000,477,26846,7,761133,1187584,426451
73000,373,26919,9,738903,1059835,320932
73000,580,26780,9,787824,928395,140571
73000,606,26802,8,991911,1107625,115714
73000,299,26953,8,764661,1140941,376280
73000,217,26880,8,871012,1000132,129120
73000,108,26829,7,1087741,1114244,26503
73000,246,26878,7,735019,982711,247692
73000,361,26859,7,788318,1086021,297703
73000,196,26918,8,740801,993723,252922
73000,92,27015,7,938426,987306,48880
73000,378,26997,8,736145,966917,230772
73000,153,26989,9,756705,1012671,255966
73000,344,26654,7,922679,989721,67042
73000,160,26858,7,966979,1052622,85643
73000,208,26852,7,855576,1177830,322254
73000,194,26862,7,949331,963483,14152
73000,522,27000,8,835582,1040394,204812
73000,368,26820,8,805751,950009,144258
73000,269,26826,8,845696,1030934,185238
73000,377,26992,8,875750,1363559,487809
73000,515,26885,7,756097,1023316,267219
73000,566,26764,7,769701,1026013,256312
73000,335,26875,8,711652,946820,235168
73000,176,26701,8,849580,1056042,206462
73000,319,26923,7,876252,1013698,137446
73000,271,26751,7,792423,981140,188717
73000,343,26869,7,1033740,1057516,23776
73000,130,26957,7,953321,1001762,48441
73000,304,26946,8,1073584,1103686,30102
73000,193,26839,9,780728,994348,213620
74000,194,27213,7,907216,1082692,175476
74000,187,27212,7,929537,1019400,89863
74000,214,27293,7,763434,1116947,353513
74000,200,27197,7,1062966,1221837,158871
74000,340,27243,8,734202,1151739,417537
74000,265,27107,8,742452,1051253,308801
74000,233,27217,7,832551,1048898,216347
74000,296,27386,8,849759,979526,129767
74000,126,27282,8,870737,1030628,159891
74000,232,27111,8,756130,1124000,367870
74000,169,27204,7,830231,936104,105873
74000,495,27322,7,738329,1105591,367262
74000,92,27081,7,900730,1017881,117151
74000,323,27155,8,865792,1089555,223763
74000,371,27428,8,1016932,1197256,180324
74000,337,27136,8,778706,997756,219050
74000,397,27353,7,752089,972521,220432
74000,473,27185,7,920182,1009386,89204
74000,260,27211,8,830468,1188201,357733
74000,256,27346,8,865926,1085135,219209
74000,353,27195,7,794068,1026850,232782
74000,672,27229,8,784723,1310042,525319
74000,414,27207,8,791871,1148903,357032
74000,214,27188,7,797509,1164275,366766
74000,324,27195,8,891320,1032673,141353
74000,216,27110,8,961223,994562,33339
74000,412,27136,7,887851,986224,98373
74000,445,27356,7,964191,1083822,119631
74000,276,27240,8,798063,1168581,370518
74000,145,27391,7,922223,1225576,303353
74000,250,27315,7,799378,1143660,344282
74000,251,27236,8,1254722,1317385,62663
74000,289,27097,8,894097,1107841,213744
74000,248,27173,9,868385,998708,130323
74000,380,27222,8,965479,1013829,48350
74000,534,27110,8,762347,908861,146514
74000,427,27172,7,913400,1186726,273326
74000,591,27290,8,895956,947294,51338
74000,199,27173,8,956237,1154568,198331
74000,982,27243,8,839900,1049698,209798
74000,691,27239,8,759972,1051711,291739
74000,114,27147,9,816384,1238186,421802
74000,356,27121,7,761053,1176023,414970
74000,523,27294,7,929033,980562,51529
74000,251,27176,8,747940,1035328,287388
74000,592,27146,7,759473,967773,208300
74000,314,27355,8,784879,1077014,292135
74000,356,27265,7,939774,974340,34566
74000,390,27301,8,932049,1174017,241968
74000,77,27371,8,879848,948503,68655
75000,714,27501,8,842756,1188811,346055
75000,216,27766,7,883194,1007945,124751
75000,439,27576,7,735809,909740,173931
75000,270,27525,7,920618,1208762,288144
75000,142,27650,7,790583,992761,202178
75000,414,27619,8,819685,997396,177711
75000,446,27628,9,870278,1254540,384262
75000,532,27685,7,982586,1183770,201184
75000,290,27565,8,831312,1169391,338079
75000,64,27526,8,1038260,1060953,22693
75000,88,27577,8,816307,1136631,320324
75000,132,27542,7,836204,1064539,228335
75000,293,27533,8,843166,926917,83751
75000,145,27544,7,862585,1197894,335309
75000,350,27463,7,888651,957824,69173
75000,210,27577,8,856454,1045597,189143
75000,196,27611,7,794992,1079485,284493
75000,590,27625,8,1016972,1080406,63434
75000,334,27770,8,836306,953322,117016
75000,337,27474,8,909566,980943,71377
75000,468,27571,7,1067024,1311052,244028
75000,504,27432,8,863682,1140693,277011
75000,416,27582,7,845940,940133,94193
75000,265,27393,9,903009,1045682,142673
75000,359,27660,10,1035187,1051004,15817
75000,485,27541,7,846086,950785,104699
75000,109,27627,8,927764,1131175,203411
75000,455,27489,8,810029,1037533,227504
75000,213,27641,7,916109,950152,34043
75000,398,27575,7,802199,982773,180574
75000,32,27546,8,837912,1071213,233301
75000,911,27599,7,869659,1159702,290043
75000,610,27688,7,845246,1065890,220644
75000,484,27600,7,795495,1016228,220733
75000,723,27812,7,907509,1153248,245739
75000,636,27555,7,775166,979285,204119
75000,551,27517,8,932099,1039217,107118
75000,582,27525,8,871800,1066316,194516
75000,555,27505,8,843582,1076195,232613
75000,259,27705,7,866416,983439,117023
75000,315,27511,8,768515,994166,225651
75000,793,27600,8,838220,1093089,254869
75000,335,27474,7,956835,1173609,216774
75000,150,27601,7,990138,1064351,74213
75000,105,27615,7,821822,957864,136042
75000,551,27509,7,967265,1073861,106596
75000,171,27792,7,977324,1112858,135534
75000,191,27639,8,915225,956727,41502
75000,281,27571,7,893009,1157543,264534
75000,191,27569,7,832882,1247630,414748
76000,257,27945,8,943019,1124380,181361
76000,537,28026,8,865649,1073428,207779
76000,312,28066,8,1130723,1166699,35976
76000,665,28014,8,1023045,1276777,253732
76000,323,28017,8,896443,1141203,244760
76000,113,27967,8,956261,1067660,111399
76000,313,28072,8,886993,987621,100628
76000,418,27870,8,830762,1204731,373969
76000,465,27890,9,820471,1355392,534921
76000,926,27983,7,871548,1118877,247329
76000,150,27899,7,927491,1185635,258144
76000,281,27912,7,811043,1142805,331762
76000,360,27952,8,769128,1145600,376472
76000,453,27896,8,844177,1133214,289037
76000,277,28022,8,816616,1143463,326847
76000,679,27878,9,855397,1200867,345470
76000,631,27938,10,870325,1116549,246224
76000,738,27886,7,1011753,1058825,47072
76000,371,27820,7,1051683,1248099,196416
76000,297,28027,8,955166,1224196,269030
76000,54,27965,7,777555,1068673,291118
76000,133,27904,8,795528,1081542,286014
76000,235,28020,7,941435,1142915,201480
76000,233,27833,7,823185,1029777,206592
76000,373,27977,8,1116740,1197974,81234
76000,375,28039,7,964648,1011616,46968
76000,379,28001,8,1151566,1195576,44010
76000,336,28079,8,836496,1008131,171635
76000,564,27970,8,818437,1027578,209141
76000,416,27890,7,836649,1041473,204824
76000,274,27887,7,783110,1006552,223442
76000,336,27920,7,938797,1189116,250319
76000,357,27934,8,1026124,1149373,123249
76000,90,27913,7,831088,1089216,258128
76000,435,27868,7,862964,1078280,215316
76000,580,27964,7,820347,1137751,317404
76000,127,28054,7,907292,1035490,128198
76000,231,27842,8,924602,1049809,125207
76000,937,27904,8,860623,1033449,172826
76000,401,27900,8,823350,1114227,290877
76000,216,27914,7,693037,997706,304669
76000,310,27921,8,1098019,1447075,349056
76000,413,27937,8,847890,1162899,315009
76000,409,28009,8,924943,1256020,331077
76000,735,27932,8,939314,1323231,383917
76000,266,27855,7,856183,1031943,175760
76000,322,28043,7,1367092,1423752,56660
76000,163,27848,8,812233,1127359,315126
76000,371,27935,8,868305,1010429,142124
76000,646,27881,7,983586,1055201,71615
77000,240,28421,7,959284,1116532,157248
77000,449,28331,7,794560,1053313,258753
77000,413,28426,8,1139284,1159610,20326
77000,265,28430,8,1144128,1267798,123670
77000,254,28448,8,930862,1066971,136109
77000,98,28331,8,1287224,1356106,68882
77000,520,28196,9,857710,1140185,282475
77000,271,28224,7,854932,1180404,325472
77000,396,28231,8,920571,1028929,108358
77000,263,28221,7,919133,1254576,335443
77000,430,28387,8,853481,1101317,247836
77000,359,28286,7,846973,1066340,219367
77000,384,28334,8,959953,974989,15036
77000,267,28265,7,1004539,1323239,318700
77000,510,28414,8,863096,1080386,217290
77000,338,28447,7,1019667,1050556,30889
77000,200,28394,8,881482,1210369,328887
77000,433,28178,8,869302,1197634,328332
77000,400,28305,7,921148,1086362,165214
77000,299,28451,8,1219085,1261684,42599
77000,133,28306,7,1004088,1067155,63067
77000,124,28300,8,787477,1115479,328002
77000,245,28417,7,1025557,1302810,277253
77000,382,28166,7,969761,1175836,206075
77000,648,28337,8,884537,1022456,137919
77000,599,28179,8,949082,1070148,121066
77000,261,28310,8,957628,1026527,68899
77000,425,28356,9,1008843,1166731,157888
77000,26,28400,9,958394,1146280,187886
77000,266,28371,7,1109849,1133775,23926
77000,173,28485,8,1003299,1106002,102703
77000,395,28492,7,794571,1101706,307135
77000,64,28324,8,948021,1085952,137931
77000,320,28324,9,932141,1011333,79192
77000,67,28439,8,865603,1086173,220570
77000,116,28424,8,932876,1069319,136443
77000,239,28360,7,964639,1301987,337348
77000,279,28427,9,894236,1093711,199475
77000,239,28501,7,844845,1017040,172195
77000,355,28417,7,801668,1158471,356803
77000,415,28220,8,1123273,1178703,55430
77000,393,28247,8,1007799,1127482,119683
77000,193,28417,8,974200,1140766,166566
77000,331,28389,7,847241,1064265,217024
77000,332,28491,8,1048851,1137928,89077
77000,209,28239,8,787706,1126467,338761
77000,226,28372,7,759497,1033306,273809
77000,513,28279,8,820734,1109701,288967
77000,258,28244,7,908845,1143943,235098
77000,132,28386,7,868428,1240801,372373
78000,126,28730,8,918016,1100354,182338
78000,211,28813,8,948372,1269973,321601
78000,722,28807,8,901588,1025880,124292
78000,527,28596,8,847955,1059843,211888
78000,464,28635,7,817581,1043713,226132
78000,542,28675,7,967019,1086136,119117
78000,463,28667,8,1078779,1405955,327176
78000,506,28515,8,1062580,1254250,191670
78000,291,28800,9,802666,1087183,284517
78000,300,28790,7,843987,1097622,253635
78000,324,28679,8,859641,1083970,224329
78000,380,28598,7,930722,1022792,92070
78000,506,28667,8,771527,972137,200610
78000,533,28728,7,888682,983864,95182
78000,377,28722,6,789414,1455992,666578
78000,236,28635,8,885694,1069147,183453
78000,290,28638,7,874137,1364620,490483
78000,490,28710,7,976109,1211649,235540
78000,236,28857,8,835550,1066809,231259
78000,194,28733,7,891906,1104966,213060
78000,271,28802,9,950993,1044163,93170
78000,486,28541,7,823921,1350506,526585
78000,688,28578,9,800516,1021983,221467
78000,514,28679,7,881778,1000959,119181
78000,605,28689,8,912737,1152901,240164
78000,620,28722,7,826693,1132577,305884
78000,311,28729,8,870548,1082204,211656
78000,363,28845,9,914047,1180461,266414
78000,49,28794,7,896003,1145174,249171
78000,352,28726,9,828932,1037484,208552
78000,512,28796,8,787741,1170439,382698
78000,614,28734,8,959268,1122118,162850
78000,189,28766,7,780745,1059808,279063
78000,458,28599,7,875794,1061246,185452
78000,338,28899,7,999523,1172577,173054
78000,263,28634,7,859146,1096581,237435
78000,389,28715,7,865293,1004796,139503
78000,283,28797,9,865349,1109341,243992
78000,262,28733,7,859531,1303587,444056
78000,265,28576,7,862214,1055731,193517
78000,429,28695,8,862565,1394824,532259
78000,101,28651,7,894480,1348888,454408
78000,528,28525,7,877237,1055990,178753
78000,498,28735,8,920576,1188171,267595
78000,474,28609,7,821638,1103570,281932
78000,707,28759,8,961204,1062903,101699
78000,178,28766,8,857665,1206370,348705
78000,372,28754,7,1006135,1211914,205779
78000,103,28821,7,877053,1169013,291960
78000,336,28578,7,827271,1571632,744361
79000,373,29102,8,1161773,1225658,63885
79000,679,29034,7,990749,1296909,306160
79000,154,29204,9,947885,1112626,164741
79000,663,29064,8,831803,974575,142772
79000,500,29192,8,889259,1141414,252155
79000,309,29002,8,904940,1079627,174687
79000,545,29126,8,855752,1009421,153669
79000,263,28972,7,806234,1192145,385911
79000,678,29136,8,911387,1015911,104524
79000,158,29079,8,1027669,1135145,107476
79000,336,28981,8,1140474,1157131,16657
79000,374,29106,8,841644,1019624,177980
79000,35,28903,8,833824,1161629,327805
79000,455,29032,7,856578,1142864,286286
79000,635,29148,8,948860,994406,45546
79000,509,28922,7,1103928,1164896,60968
79000,308,29050,8,1004972,1056694,51722
79000,342,29047,7,883857,1026372,142515
79000,269,28939,7,953179,1034645,81466
79000,335,29106,8,1106352,1147697,41345
79000,119,29019,8,952200,1086156,133956
79000,387,29027,7,1040933,1125668,84735
79000,657,29139,7,917246,1120378,203132
79000,300,28925,8,1062289,1204750,142461
79000,625,28926,8,1009124,1260985,251861
79000,686,29113,7,1102657,1297406,194749
79000,17,29108,7,777012,1162919,385907
79000,86,29101,7,857750,1187421,329671
79000,346,29038,8,843544,1145074,301530
79000,589,29073,8,871548,1152536,280988
79000,101,29149,7,957509,1112165,154656
79000,328,28988,7,863336,1115214,251878
79000,276,29105,7,874247,1138832,264585
79000,448,29081,8,922810,1097357,174547
79000,238,29068,7,860556,1158920,298364
79000,113,29083,7,987644,1148906,161262
79000,303,28926,7,896633,1111351,214718
79000,425,28995,8,876971,1072220,195249
79000,431,28888,8,977423,1152809,175386
79000,359,28975,7,1251387,1310811,59424
79000,137,28902,7,1161637,1200760,39123
79000,449,29124,8,935053,1124796,189743
79000,369,29171,7,922263,1109126,186863
79000,361,28970,8,857775,1145093,287318
79000,457,29039,7,885346,1075659,190313
79000,265,28975,8,922200,1191258,269058
79000,613,28952,8,1143515,1264459,120944
79000,342,28909,8,943724,1221289,277565
79000,234,28974,8,822771,1249014,426243
79000,234,29077,8,968125,1073345,105220
80000,204,29465,7,904051,1097443,193392
80000,565,29382,7,864478,1013924,149446
80000,272,29217,7,1114356,1181230,66874
80000,384,29530,7,987697,1237020,249323
80000,78,29504,8,1017570,1048611,31041
80000,323,29482,9,887870,1028738,140868
80000,410,29443,8,944263,1247611,303348
80000,340,29448,8,1013214,1094564,81350
80000,308,29449,7,806143,1063981,257838
80000,330,29444,8,863915,1146768,282853
80000,584,29275,7,1094697,1233372,138675
80000,692,29397,7,1123041,1322149,199108
80000,406,29397,7,788848,1225332,436484
80000,344,29685,8,814697,1079239,264542
80000,36,29456,9,912025,1223373,311348
80000,270,29500,8,893284,1078322,185038
80000,406,29377,8,912955,1071169,158214
80000,248,29399,7,999374,1140335,140961
80000,543,29426,7,906797,1226416,319619
80000,169,29466,8,948706,1046474,97768
80000,493,29365,7,791899,1054729,262830
80000,105,29442,8,1047361,1136996,89635
80000,209,29449,8,965405,1113806,148401
80000,268,29403,7,878736,1137435,258699
80000,364,29428,7,916765,1209119,292354
80000,239,29414,8,836012,1204085,368073
80000,273,29422,8,807827,1559570,751743
80000,375,29492,7,879615,1199938,320323
80000,324,29414,8,827917,1052273,224356
80000,370,29472,7,988677,1251025,262348
80000,360,29467,8,907279,1149274,241995
80000,234,29545,7,962136,1249667,287531
80000,133,29548,8,885506,1175826,290320
80000,321,29415,7,1179787,1244520,64733
80000,382,29590,8,897848,1231330,333482
80000,369,29332,9,1080387,1280531,200144
80000,75,29541,8,864277,1305839,441562
80000,479,29399,9,910426,1144560,234134
80000,261,29447,7,1126474,1197173,70699
80000,162,29527,7,1171605,1207729,36124
80000,269,29442,7,980761,1213659,232898
80000,552,29324,8,1025562,1067724,42162
80000,194,29377,7,1036004,1044464,8460
80000,194,29602,8,898488,1218088,319600
80000,388,29471,8,1069774,1226251,156477
80000,398,29416,7,1020363,1150395,130032
80000,263,29381,8,903451,1046025,142574
80000,247,29426,7,844445,1211976,367531
80000,61,29360,8,863729,1125402,261673
80000,413,29614,7,1036294,1104053,67759
81000,590,29849,7,1024700,1081770,57070
81000,227,29851,7,860215,1140193,279978
81000,553,29710,8,985215,1264207,278992
81000,236,29886,7,876616,1068013,191397
81000,400,29765,7,1149308,1515370,366062
81000,347,29799,10,1066307,1116915,50608
81000,493,29790,9,1033559,1269104,235545
81000,248,29713,8,824493,1055689,231196
81000,725,29805,8,848902,1132221,283319
81000,173,29670,7,1048832,1338627,289795
81000,248,29696,8,998270,1513594,515324
81000,663,29878,8,964358,1058102,93744
81000,219,29720,7,916385,1336759,420374
81000,731,29877,8,925135,1239146,314011
81000,650,29884,7,1029817,1159814,129997
81000,695,29751,7,914503,1383696,469193
81000,274,29838,8,1115107,1396102,280995
81000,527,29648,8,905664,1154134,248470
81000,191,29726,8,920983,1176594,255611
81000,578,29821,7,1011230,1266585,255355
81000,489,29794,7,810094,1167845,357751
81000,525,29817,8,1037374,1075038,37664
81000,411,30005,8,1060242,1143937,83695
81000,225,29806,8,952354,1193818,241464
81000,706,29748,8,943451,1226982,283531
81000,766,29862,8,1037864,1203578,165714
81000,524,29940,7,883970,1400806,516836
81000,429,29739,7,993875,1185958,192083
81000,473,29839,7,987001,1143617,156616
81000,263,29722,7,954152,1207442,253290
81000,137,29844,9,802936,1194501,391565
81000,623,29671,7,972464,1097467,125003
81000,211,29674,7,927618,1017911,90293
81000,928,29822,8,1021944,1231010,209066
81000,337,29854,7,1008161,1270380,262219
81000,217,29824,8,920271,1105102,184831
81000,335,29832,7,934215,1072115,137900
81000,367,29863,8,966540,1221434,254894
81000,95,29715,7,899106,1078526,179420
81000,697,29744,8,895601,1080114,184513
81000,36,29759,7,891437,1229434,337997
81000,848,29866,8,794301,1205665,411364
81000,744,29793,7,923056,1202253,279197
81000,334,29571,9,980446,1513173,532727
81000,427,29784,9,832127,1108086,275959
81000,104,29620,8,779057,1132824,353767
81000,384,29786,8,901790,1025106,123316
81000,329,29800,8,1009165,1044268,35103
81000,217,29819,8,981902,1035277,53375
81000,407,29939,7,1124518,1442869,318351
82000,349,30173,7,1032249,1185421,153172
82000,163,30214,8,992742,1354233,361491
82000,577,30136,7,916918,979787,62869
82000,269,29916,7,989933,1129513,139580
82000,360,30126,9,1020573,1053007,32434
82000,125,30193,8,1077080,1249879,172799
82000,467,30284,7,948486,1024549,76063
82000,630,30021,8,988774,1230084,241310
82000,241,30155,7,1228184,1253950,25766
82000,460,30154,7,945530,1022065,76535
82000,206,30173,7,1028975,1076975,48000
82000,401,30161,8,942912,1040878,97966
82000,254,30061,7,928144,1176155,248011
82000,565,30170,8,1087731,1130579,42848
82000,172,30299,7,1033000,1224217,191217
82000,311,30060,7,876152,1235294,359142
82000,132,30220,8,1045945,1158233,112288
82000,56,30228,7,1035401,1167770,132369
82000,206,30088,7,1042682,1294003,251321
82000,477,30117,7,942432,1204743,262311
82000,200,30220,7,902441,1116704,214263
82000,473,30120,8,908512,1118343,209831
82000,532,30339,8,1004226,1286107,281881
82000,256,30040,7,1258116,1396374,138258
82000,318,30175,8,1041767,1289049,247282
82000,543,30252,8,1023004,1200970,177966
82000,210,30409,8,898233,1280797,382564
82000,174,30184,9,1028599,1129579,100980
82000,82,30335,7,988770,1102137,113367
82000,285,30196,8,952339,1091809,139470
82000,256,30240,7,944182,1170420,226238
82000,345,30028,8,894822,1089669,194847
82000,154,30198,7,904980,1145397,240417
82000,338,30096,8,931598,1311165,379567
82000,671,30111,8,909048,1181772,272724
82000,390,30070,7,1125296,1397304,272008
82000,446,29934,7,851611,1158178,306567
82000,801,30156,7,1178761,1253885,75124
82000,366,30179,8,1063561,1206248,142687
82000,411,30073,7,828190,1300683,472493
82000,213,30139,7,926818,1560293,633475
82000,424,30062,8,991053,1115398,124345
82000,208,30137,8,1111459,1157065,45606
82000,296,30014,8,1042659,1155872,113213
82000,307,30071,8,939778,1130648,190870
82000,303,30202,8,808270,1178440,370170
82000,166,30164,7,1069583,1136352,66769
82000,523,29971,8,990355,1217649,227294
82000,210,30138,8,893929,1210247,316318
82000,525,30148,9,920200,1107362,187162
83000,85,30549,7,948004,1195195,247191
83000,353,30506,7,931325,1135343,204018
83000,259,30548,7,844624,1197993,353369
83000,363,30460,7,921965,1289914,367949
83000,394,30471,7,1057303,1285539,228236
83000,561,30517,8,949514,1281740,332226
83000,296,30436,7,1059333,1146162,86829
83000,373,30413,8,1055809,1189568,133759
83000,278,30659,8,1026837,1223492,196655
83000,625,30491,7,874478,1449223,574745
83000,433,30583,8,886950,1153582,266632
83000,339,30447,8,1148920,1171354,22434
83000,338,30378,7,1052991,1189568,136577
83000,331,30416,8,818324,1192657,374333
83000,783,30499,8,1019577,1257522,237945
83000,272,30404,7,929454,1094289,164835
83000,419,30351,7,924758,1309235,384477
83000,247,30565,7,1025134,1173527,148393
83000,501,30508,8,845912,1278661,432749
83000,308,30513,8,1093059,1210950,117891
83000,25,30475,8,1009537,1312380,302843
83000,469,30470,7,975027,1147437,172410
83000,255,30727,7,1047077,1214101,167024
83000,379,30475,8,914271,1255791,341520
83000,692,30347,8,920890,1097864,176974
83000,736,30527,8,963546,1101914,138368
83000,254,30617,8,1031065,1161186,130121
83000,336,30410,9,989949,1341277,351328
83000,313,30329,7,912577,1282869,370292
83000,543,30632,7,985599,1138505,152906
83000,474,30451,9,925827,1326873,401046
83000,33,30456,7,887166,1048879,161713
83000,339,30462,7,1014988,1210753,195765
83000,521,30428,7,968829,1185146,216317
83000,383,30597,8,1008456,1172019,163563
83000,543,30479,8,882854,1247886,365032
83000,366,30480,8,858358,1139969,281611
83000,288,30498,8,951097,1388621,437524
83000,197,30822,9,1100282,1325557,225275
83000,432,30541,8,924893,1245681,320788
83000,169,30365,8,1030471,1297733,267262
83000,659,30485,7,987478,1187319,199841
83000,374,30668,7,976544,1139220,162676
83000,414,30547,7,1004957,1347636,342679
83000,146,30428,7,968728,1224390,255662
83000,381,30583,7,1119613,1235996,116383
83000,265,30625,8,891800,1141395,249595
83000,251,30588,7,871968,1225551,353583
83000,325,30660,8,963588,1163698,200110
83000,489,30436,10,997724,1156337,158613
84000,448,30804,8,868730,1195189,326459
84000,535,30954,8,1166497,1217720,51223
84000,117,30902,8,1046567,1157267,110700
84000,312,30905,8,993871,1196996,203125
84000,244,31068,7,1073943,1364294,290351
84000,236,30911,7,987531,1225548,238017
84000,478,30938,7,916383,1151325,234942
84000,394,31002,8,953021,1039795,86774
84000,353,30828,9,1107540,1249437,141897
84000,760,30806,7,936878,1241701,304823
84000,172,31024,7,961199,1163636,202437
84000,336,31073,8,863347,1032635,169288
84000,918,30895,7,893817,1262370,368553
84000,701,30970,9,1248590,1384881,136291
84000,550,30961,8,937307,1196199,258892
84000,320,31024,7,930044,1160028,229984
84000,603,30757,8,929920,1230329,300409
84000,284,30902,8,973702,1217846,244144
84000,288,30843,8,934209,1138695,204486
84000,631,30932,7,849860,1251579,401719
84000,568,30884,7,923383,1327018,403635
84000,316,31010,7,983965,1080231,96266
84000,278,30867,8,1114191,1285284,171093
84000,435,31158,7,1004114,1133230,129116
84000,633,30912,7,853879,1083789,229910
84000,403,30818,7,990455,1121297,130842
84000,506,30915,7,1216790,1668078,451288
84000,720,30902,7,988331,1277699,289368
84000,564,30986,8,997469,1335304,337835
84000,901,30929,7,1040207,1168722,128515
84000,555,30960,8,913956,1236571,322615
84000,112,30929,8,953187,1234321,281134
84000,645,30848,9,1018923,1118133,99210
84000,518,31069,9,900627,1222524,321897
84000,678,30951,7,921587,1143072,221485
84000,351,30868,7,982082,1105760,123678
84000,261,31043,8,1088781,1294495,205714
84000,146,30956,7,884837,1037389,152552
84000,177,30940,7,1275657,1281094,5437
84000,682,31058,7,960066,1072672,112606
84000,152,30939,8,903054,1294885,391831
84000,278,30958,9,1079333,1192096,112763
84000,770,30994,8,960576,1173435,212859
84000,405,30989,8,978971,1123938,144967
84000,322,30980,7,898796,1184805,286009
84000,39,30767,8,943010,1216078,273068
84000,387,30778,9,879531,1285681,406150
84000,364,30950,8,953413,1546198,592785
84000,278,30774,8,997503,1290928,293425
84000,253,30779,8,862884,1037992,175108
85000,317,31308,7,1053424,1454184,400760
85000,227,31330,7,1375500,1619034,243534
85000,314,31270,8,968459,1260035,291576
85000,132,31342,8,879735,1085295,205560
85000,144,31226,7,1010388,1135077,124689
85000,266,31285,7,1175320,1232526,57206
85000,302,31104,7,992751,1216999,224248
85000,584,31397,8,914919,1481438,566519
85000,137,31408,8,1186912,1234459,47547
85000,232,31409,8,894244,1208124,313880
85000,682,31264,7,949800,1295847,346047
85000,281,31253,8,1121393,1243109,121716
85000,397,31311,7,930243,1256815,326572
85000,611,31184,8,880331,1489178,608847
85000,61,31183,7,1045418,1102600,57182
85000,543,31336,7,1218805,1325918,107113
85000,74,31153,8,863312,1353233,489921
85000,174,31303,7,961982,1470693,508711
85000,481,31481,8,947031,1316588,369557
85000,365,31336,8,942991,1080470,137479
85000,512,31345,9,1042145,1329934,287789
85000,302,31335,7,1035102,1091624,56522
85000,341,31330,7,1294285,1328294,34009
85000,397,31003,9,1122199,1203447,81248
85000,772,31267,7,911390,1141501,230111
85000,325,30955,7,882973,1163755,280782
85000,223,31300,8,950964,1247759,296795
85000,299,31227,8,968691,1184448,215757
85000,231,31076,8,975842,1221582,245740
85000,336,31226,8,983831,1240240,256409
85000,546,31309,9,1168690,1267354,98664
85000,409,31075,8,1288318,1422859,134541
85000,212,31128,8,845342,1407618,562276
85000,658,31357,7,946948,1156650,209702
85000,334,31294,7,1088383,1260271,171888
85000,452,31209,7,928309,1245050,316741
85000,509,31240,8,1102689,1229753,127064
85000,334,31386,8,944807,1136372,191565
85000,696,31166,9,994392,1234042,239650
85000,99,31293,9,985250,1221607,236357
85000,575,31304,7,1204587,1281118,76531
85000,207,31429,8,1036037,1230544,194507
85000,489,31244,7,1059183,1330541,271358
85000,295,31432,7,931832,1138317,206485
85000,136,31185,8,960057,1104106,144049
85000,391,31372,7,1093272,1275940,182668
85000,692,31225,8,920362,1236706,316344
85000,292,31213,7,920028,1209168,289140
85000,236,31316,7,1005342,1099481,94139
85000,469,31341,8,1020457,1148598,128141
86000,309,31684,8,992958,1282099,289141
86000,276,31747,8,963920,1129059,165139
86000,171,31571,8,970829,1341027,370198
86000,438,31714,8,937464,1242584,305120
86000,174,31676,7,1001868,1226810,224942
86000,229,31521,7,1021943,1231500,209557
86000,122,31613,7,917422,1213647,296225
86000,161,31492,7,1016092,1145379,129287
86000,151,31608,8,1072100,1200767,128667
86000,275,31606,8,955579,1312959,357380
86000,109,31584,7,1063588,1225855,162267
86000,268,31493,8,1246844,1335944,89100
86000,638,31606,8,1004487,1293232,288745
86000,604,31736,8,976322,1189615,213293
86000,298,31587,7,1064754,1192198,127444
86000,109,31649,7,1175068,1256952,81884
86000,228,31584,8,889321,1186878,297557
86000,329,31684,9,881890,1221127,339237
86000,408,31610,8,978203,1329247,351044
86000,751,31677,7,1140314,1296471,156157
86000,599,31681,7,950799,1241881,291082
86000,375,31551,8,1186188,1748991,562803
86000,533,31716,8,922430,1330268,407838
86000,243,31676,7,1019152,1192304,173152
86000,286,31598,7,1274665,1321793,47128
86000,173,31579,8,946094,1254085,307991
86000,383,31527,7,1050382,1143132,92750
86000,395,31813,8,952111,1223400,271289
86000,397,31651,7,1029487,1339308,309821
86000,430,31771,9,1008681,1184028,175347
86000,25,31650,8,1372489,1402148,29659
86000,692,31647,7,912983,1090087,177104
86000,348,31680,8,1023058,1320433,297375
86000,218,31672,7,926152,1307002,380850
86000,731,31726,7,832553,1232519,399966
86000,618,31597,8,1180058,1252187,72129
86000,252,31634,9,1179753,1365738,185985
86000,128,31495,7,1209060,1518031,308971
86000,618,31553,10,1147683,1301987,154304
86000,430,31632,8,931531,1185373,253842
86000,750,31648,8,1040396,1199591,159195
86000,180,31727,7,1068286,1235208,166922
86000,47,31745,8,1009535,1126136,116601
86000,782,31608,8,879280,1096462,217182
86000,274,31656,7,1148520,1239914,91394
86000,152,31595,7,1015723,1265218,249495
86000,363,31714,7,1103366,1127746,24380
86000,170,31496,7,861789,1207693,345904
86000,736,31644,8,1068792,1324473,255681
86000,277,31619,7,1101322,1198097,96775
87000,465,31959,8,981731,1387034,405303
87000,480,31951,8,1046307,1246939,200632
87000,353,31899,7,1252376,1253572,1196
87000,767,31816,7,1253924,1505835,251911
87000,330,31963,8,1138817,1382066,243249
87000,145,31881,8,986004,1154283,168279
87000,705,32113,8,1068231,1445716,377485
87000,284,31957,9,976041,1069743,93702
87000,352,32114,8,978854,1255441,276587
87000,549,31980,8,990673,1179254,188581
87000,368,32040,8,1111669,1216817,105148
87000,236,31982,8,1133261,1275452,142191
87000,780,32125,7,1009167,1213761,204594
87000,256,31918,8,1192835,1533994,341159
87000,136,32064,8,1195639,1356977,161338
87000,571,32048,8,1126516,1274994,148478
87000,672,32018,7,1055510,1140244,84734
87000,392,31990,8,921492,1279975,358483
87000,41,31969,7,981165,1344570,363405
87000,598,31891,8,1162013,1245809,83796
87000,652,31925,8,1288863,1418194,129331
87000,411,31987,9,1046430,1136214,89784
87000,192,31951,8,971330,1341616,370286
87000,159,31938,8,951906,1315312,363406
87000,137,31880,7,904574,1272023,367449
87000,644,32149,8,1088717,1250868,162151
87000,362,32123,8,1075639,1085892,10253
87000,280,32128,7,956220,1215420,259200
87000,659,32038,8,879834,1095003,215169
87000,255,32110,9,976967,1301757,324790
87000,421,31999,8,1101128,1261185,160057
87000,651,32195,8,1168040,1318385,150345
87000,404,31925,9,973883,1375357,401474
87000,369,31960,8,1141016,1312777,171761
87000,540,32012,8,1016650,1214515,197865
87000,136,31920,7,1110929,1295105,184176
87000,327,32094,8,1197620,1281683,84063
87000,394,32164,8,1152662,1307376,154714
87000,322,31847,7,989658,1291906,302248
87000,734,32048,7,1059596,1149597,90001
87000,141,32029,8,996772,1361238,364466
87000,348,31921,8,904357,1127787,223430
87000,771,32129,7,975931,1120805,144874
87000,469,32073,8,1084858,1148132,63274
87000,608,31871,8,1169395,1313767,144372
87000,669,32182,8,1083129,1191574,108445
87000,732,32021,8,1052670,1205210,152540
87000,187,32033,8,1238500,1452756,214256
87000,655,32078,9,867138,1250579,383441
87000,177,32010,7,1198781,1358826,160045
88000,377,32487,7,940791,1455830,515039
88000,166,32262,8,1060147,1445586,385439
88000,640,32161,8,899003,1223734,324731
88000,188,32427,8,979104,1255486,276382
88000,404,32407,7,992849,1202761,209912
88000,484,32353,7,1054948,1333205,278257
88000,142,32467,8,829612,1262219,432607
88000,176,32261,9,1016667,1253597,236930
88000,255,32562,8,944945,1419564,474619
88000,304,32374,7,1029509,1189502,159993
88000,280,32213,8,1189467,1372174,182707
88000,225,32304,7,928093,1378300,450207
88000,132,32393,7,938758,1162034,223276
88000,422,32569,8,908887,1321624,412737
88000,305,32294,7,1008167,1441797,433630
88000,447,32267,8,1208743,1215349,6606
88000,28,32513,8,1133270,1608058,474788
88000,401,32405,9,1068195,1227387,159192
88000,202,32243,7,952742,1536244,583502
88000,291,32348,7,993367,1277935,284568
88000,738,32403,7,1629128,1896669,267541
88000,381,32358,8,1013136,1617025,603889
88000,93,32312,7,975408,1247255,271847
88000,394,32357,7,987953,1182479,194526
88000,245,32339,8,1273685,1287928,14243
88000,377,32282,7,1074944,1221566,146622
88000,536,32390,8,982828,1148891,166063
88000,410,32300,8,1244713,1373763,129050
88000,157,32391,7,975452,1183743,208291
88000,120,32330,8,1052669,1176225,123556
88000,464,32477,8,995847,1208904,213057
88000,216,32317,7,1066440,1331488,265048
88000,471,32381,8,1066020,1388380,322360
88000,373,32536,7,1289531,1399955,110424
88000,612,32364,7,929679,1300625,370946
88000,523,32386,8,1024979,1221285,196306
88000,547,32401,8,1166297,1411585,245288
88000,626,32397,8,1247285,1693670,446385
88000,533,32263,8,1117855,1376091,258236
88000,421,32424,8,1032373,1417489,385116
88000,173,32459,7,1031546,1228962,197416
88000,251,32487,7,1139525,1331133,191608
88000,417,32448,9,1167425,1229481,62056
88000,462,32259,8,885555,1166675,281120
88000,264,32232,7,927424,1239173,311749
88000,461,32410,7,941187,1096569,155382
88000,499,32441,7,1155228,1395028,239800
88000,291,32218,7,891168,1313988,422820
88000,122,32586,8,907304,1316933,409629
88000,429,32498,7,1068658,1244957,176299
89000,339,32912,8,1032948,1301944,268996
89000,863,32820,8,1093362,1195424,102062
89000,806,32696,8,1152275,1417826,265551
89000,266,32762,7,921980,1261502,339522
89000,223,32778,8,1156905,1330209,173304
89000,535,32766,7,1048365,1287354,238989
89000,396,32768,8,1097225,1366880,269655
89000,381,32702,7,951712,1368115,416403
89000,107,32680,7,964732,1505671,540939
89000,387,32788,7,990069,1377599,387530
89000,378,32818,7,1187969,1269483,81514
89000,800,32661,9,1253435,1325338,71903
89000,280,32799,7,1174687,1365780,191093
89000,291,32744,7,1245012,1312451,67439
89000,279,32724,8,1028128,1152975,124847
89000,317,32764,7,1246634,1312275,65641
89000,201,32946,8,1062353,1428345,365992
89000,143,32566,7,1290357,1409504,119147
89000,486,32814,7,949101,1247446,298345
89000,345,32810,8,1037020,1331433,294413
89000,470,32845,9,1140995,1388601,247606
89000,564,32812,7,1215567,1271978,56411
89000,247,32918,8,1027794,1237759,209965
89000,331,32878,8,1048740,1669456,620716
89000,378,32858,8,1034639,1182682,148043
89000,211,32767,8,1072602,1351919,279317
89000,560,32948,8,883380,1205676,322296
89000,593,32873,8,1057479,1293921,236442
89000,102,32743,8,1095966,1140493,44527
89000,152,32838,8,999110,1211520,212410
89000,319,32908,8,924726,1158520,233794
89000,295,32770,7,998685,1165512,166827
89000,273,32778,7,919551,1292932,373381
89000,643,32860,8,929112,1189828,260716
89000,507,32563,9,947548,1366491,418943
89000,253,32700,9,1135268,1386420,251152
89000,429,32713,9,895846,1240634,344788
89000,444,32543,7,1284121,1338734,54613
89000,322,32696,7,943508,1109366,165858
89000,141,32739,7,1049220,1215551,166331
89000,105,32945,8,1357786,1363999,6213
89000,293,32767,8,1033667,1183314,149647
89000,158,32582,8,1071984,1411025,339041
89000,230,32844,7,1241188,1300633,59445
89000,155,32788,7,1211368,1242431,31063
89000,474,32651,7,1096547,1276270,179723
89000,553,32850,10,1030705,1325820,295115
89000,300,32706,8,1100126,1280385,180259
89000,461,32754,7,1027118,1327880,300762
89000,75,32712,7,1045628,1239490,193862
90000,299,33005,8,1301966,1317956,15990
90000,184,33140,10,1157087,1292245,135158
90000,468,32874,9,967699,1284052,316353
90000,232,33143,7,1149364,1305743,156379
90000,357,33249,7,1090625,1286961,196336
90000,519,33217,8,1008334,1265123,256789
90000,420,33152,7,1292147,1443103,150956
90000,331,33174,8,1365308,1468237,102929
90000,356,33155,8,1154608,1312735,158127
90000,243,32990,8,1157799,1411417,253618
90000,120,33039,8,1095608,1376899,281291
90000,378,33220,8,917551,1095527,177976
90000,168,32865,8,1084881,1472832,387951
90000,392,33149,7,1033393,1333542,300149
90000,971,33159,7,1083443,1336556,253113
90000,717,33014,8,1179451,1273936,94485
90000,385,33220,8,946534,1426292,479758
90000,390,33059,7,1050778,1294943,244165
90000,269,33131,8,1057020,1253129,196109
90000,138,33082,7,1123987,1285456,161469
90000,703,33203,8,1035560,1192996,157436
90000,338,33025,7,1169176,1314914,145738
90000,650,33038,9,987431,1308326,320895
90000,286,33104,8,991421,1220361,228940
90000,369,33107,8,978401,1371080,392679
90000,180,33100,8,1100199,1265557,165358
90000,682,33247,8,998666,1390976,392310
90000,656,33152,8,1168021,1188367,20346
90000,477,33206,9,1002365,1345545,343180
90000,213,33055,8,930958,1323540,392582
90000,499,33168,7,1070063,1276786,206723
90000,433,33169,7,1407234,1527979,120745
90000,108,33075,8,966126,1219955,253829
90000,286,32939,7,1492406,1694959,202553
90000,474,33130,9,897898,1228813,330915
90000,165,33138,7,1079891,1344676,264785
90000,221,32943,7,977793,1419895,442102
90000,553,33129,7,1046764,1228187,181423
90000,488,33226,8,1060537,1604236,543699
90000,548,32986,7,1113761,1309295,195534
90000,646,33005,8,930467,1217618,287151
90000,826,33195,10,945212,1406954,461742
90000,141,33206,8,958146,1176764,218618
90000,395,33080,7,1132294,1238348,106054
90000,427,33176,8,1008292,1330723,322431
90000,177,33203,8,1061723,1282360,220637
90000,432,33161,7,1011821,1201325,189504
90000,247,33228,9,1149880,1311259,161379
90000,331,33079,8,1192773,1245345,52572
90000,429,33035,8,1350740,1390754,40014
91000,510,33394,7,1146574,1489805,343231
91000,395,33489,8,1105032,1220415,115383
91000,556,33459,9,1729512,1747174,17662
91000,261,33508,7,961986,1299607,337621
91000,542,33474,7,998611,1334241,335630
91000,389,33582,8,1103893,1282958,179065
91000,424,33501,8,1182079,1303089,121010
91000,592,33544,7,1134121,1307914,173793
91000,804,33427,8,991810,1316933,325123
91000,267,33483,9,1195984,1368049,172065
91000,431,33550,7,1019009,1169637,150628
91000,514,33464,7,1165943,1249492,83549
91000,167,33474,8,1248682,1324628,75946
91000,468,33558,8,1058933,1260395,201462
91000,600,33408,8,988842,1334939,346097
91000,714,33325,8,1188280,1302585,114305
91000,255,33378,8,954073,1616725,662652
91000,406,33486,8,1268616,1474861,206245
91000,938,33386,7,1019687,1236038,216351
91000,515,33339,9,992593,1489316,496723
91000,417,33432,7,993053,1252072,259019
91000,552,33407,7,1195032,1384624,189592
91000,244,33376,7,1122487,1305859,183372
91000,676,33385,8,1210118,1332506,122388
91000,353,33434,7,1149988,1322760,172772
91000,316,33417,7,1035380,1438304,402924
91000,375,33378,7,993472,1298986,305514
91000,721,33234,7,1444577,1500269,55692
91000,355,33393,7,976152,1148616,172464
91000,383,33481,7,1183111,1511026,327915
91000,318,33360,8,1130002,1313933,183931
91000,356,33504,7,1059552,1487721,428169
91000,177,33447,8,992736,1273805,281069
91000,592,33606,8,1139876,1228803,88927
91000,229,33583,7,1271106,1375138,104032
91000,135,33366,8,938085,1311105,373020
91000,111,33351,8,1055545,1401003,345458
91000,300,33555,10,1138088,1232745,94657
91000,191,33488,8,1046862,1209602,162740
91000,368,33362,7,1277911,1342311,64400
91000,124,33530,7,916528,1392537,476009
91000,129,33371,8,1027913,1611428,583515
91000,411,33574,7,951822,1190258,238436
91000,603,33459,8,1119904,1388648,268744
91000,500,33518,8,1301781,1408459,106678
91000,297,33512,8,1077132,1161498,84366
91000,339,33450,8,1098866,1394108,295242
91000,349,33365,8,1155172,1311025,155853
91000,475,33484,7,1014813,1494153,479340
91000,656,33379,9,1196287,1470356,274069
92000,133,33744,10,1014363,1545555,531192
92000,447,33765,7,1155484,1364079,208595
92000,230,33979,8,986786,1462262,475476
92000,383,33665,10,1076456,1290904,214448
92000,556,33846,8,1478021,1623463,145442
92000,270,33734,8,1299639,1744798,445159
92000,775,33947,7,1203866,1358794,154928
92000,519,33983,8,928715,1220024,291309
92000,269,33741,7,1037487,1430067,392580
92000,480,33752,8,1321960,1454197,132237
92000,293,33924,7,980940,1205587,224647
92000,398,33848,9,1010152,1555931,545779
92000,379,33880,8,1192275,1367395,175120
92000,326,33949,7,1091099,1195692,104593
92000,709,33873,7,1102650,1363204,260554
92000,601,33770,7,1203711,1887798,684087
92000,307,33851,7,1061994,1349786,287792
92000,652,33887,9,1087022,1272374,185352
92000,98,34003,7,1105869,1347890,242021
92000,442,33784,8,1066152,1259531,193379
92000,177,33879,8,1224251,1534527,310276
92000,115,33691,8,1089265,1383693,294428
92000,324,33837,7,1167369,1266369,99000
92000,210,33930,8,1270905,1540743,269838
92000,507,33828,8,1102867,1384361,281494
92000,439,33807,7,1029227,1443261,414034
92000,575,33865,9,1150277,1416647,266370
92000,402,33941,7,1043605,1175249,131644
92000,374,33784,9,1121849,1259892,138043
92000,513,33735,7,929736,1177487,247751
92000,629,33920,7,1074260,1254565,180305
92000,363,34048,7,1075778,1363131,287353
92000,880,33798,9,1176634,1274909,98275
92000,488,33752,7,1078005,1272153,194148
92000,463,33993,8,1251107,1608913,357806
92000,565,33831,7,1158565,1170331,11766
92000,44,33854,8,959712,1216128,256416
92000,537,33799,8,1090123,1354882,264759
92000,27,33707,9,1239173,1481423,242250
92000,401,33993,7,1079421,1226395,146974
92000,257,33928,8,1154971,1538917,383946
92000,612,33904,8,1088311,1260327,172016
92000,297,34079,9,1132774,1402287,269513
92000,157,33760,8,1021801,1163912,142111
92000,466,33883,8,1187822,1442286,254464
92000,225,33727,8,1083873,1273168,189295
92000,283,33825,8,1280588,1405738,125150
92000,238,33898,7,995028,1597693,602665
92000,328,33913,8,1163443,1531124,367681
92000,390,33764,8,1146834,1318756,171922
93000,612,34336,7,1347414,1351261,3847
93000,239,34208,8,1101182,1403135,301953
93000,70,34093,7,983707,1203778,220071
93000,285,34245,8,1083230,1197304,114074
93000,560,34341,9,1053030,1547729,494699
93000,86,34148,8,1061252,1306099,244847
93000,278,34117,8,1088896,1404697,315801
93000,282,34404,7,1033458,1638906,605448
93000,229,34166,7,1100259,1411074,310815
93000,317,34194,8,992024,1437518,445494
93000,204,34100,7,1147670,1332986,185316
93000,136,34023,8,1064850,1588019,523169
93000,223,34242,8,1289556,1414680,125124
93000,1046,34254,8,1183014,1294994,111980
93000,117,34375,7,998736,1634541,635805
93000,310,34358,9,1136251,1483376,347125
93000,110,34068,7,992097,1365005,372908
93000,562,34206,7,1095363,1219233,123870
93000,268,34105,8,1138146,1306188,168042
93000,164,34270,8,1076787,1274845,198058
93000,423,34068,8,1148160,1417416,269256
93000,227,34204,7,1029528,1316691,287163
93000,590,34307,8,1185592,1401987,216395
93000,321,34257,8,1162633,1310009,147376
93000,264,34201,9,1137724,1666988,529264
93000,287,34093,7,1163881,1396435,232554
93000,262,34067,7,1041330,1337675,296345
93000,110,34045,8,1242831,1284096,41265
93000,713,34171,7,1147249,1334451,187202
93000,549,34263,8,955919,1204671,248752
93000,398,34259,7,1330534,1356227,25693
93000,388,34273,8,1116460,1384003,267543
93000,290,34140,8,1274525,1690733,416208
93000,373,34333,7,1106365,1172361,65996
93000,994,34210,7,1030167,1299313,269146
93000,200,34293,8,1103465,1596605,493140
93000,410,34112,8,1074699,1486052,411353
93000,747,34351,8,1347659,1415224,67565
93000,856,34146,7,1193773,1264761,70988
93000,494,34151,8,908002,1404210,496208
93000,386,34211,8,1130417,1491763,361346
93000,548,34222,8,1123296,1314266,190970
93000,569,34330,7,1046314,1341025,294711
93000,277,34452,7,971024,1421042,450018
93000,910,34259,7,1051162,1277683,226521
93000,141,34269,9,1118716,1267699,148983
93000,428,34298,7,1449383,1460071,10688
93000,372,34265,8,978168,1242354,264186
93000,278,34143,8,1040852,1361122,320270
93000,19,34280,7,1001691,1284285,282594
94000,236,34586,8,1178911,1339638,160727
94000,134,34585,8,1060370,1199337,138967
94000,326,34479,8,1052918,1301995,249077
94000,639,34603,8,1301574,1349369,47795
94000,444,34556,8,1163537,1222121,58584
94000,627,34536,7,1121357,1539045,417688
94000,337,34679,9,1066630,1339455,272825
94000,433,34741,8,1255367,1279843,24476
94000,298,34627,8,1245000,1348746,103746
94000,310,34631,8,1091624,1403764,312140
94000,502,34614,7,1138714,1155494,16780
94000,519,34320,7,1009617,1528271,518654
94000,408,34590,7,1006493,1421437,414944
94000,189,34551,8,1037033,1343412,306379
94000,632,34667,7,1308974,1710646,401672
94000,338,34515,7,1069027,1388231,319204
94000,620,34615,8,1091580,1637899,546319
94000,339,34705,7,1100316,1334126,233810
94000,87,34513,8,1376133,1625882,249749
94000,548,34641,8,1026632,1242577,215945
94000,374,34654,8,1106003,1386405,280402
94000,208,34735,10,1171845,1462784,290939
94000,149,34740,8,1113233,1305721,192488
94000,486,34723,8,1107537,1722860,615323
94000,934,34577,9,1206023,1442871,236848
94000,51,34572,7,1113255,1364385,251130
94000,359,34706,8,1199488,1333415,133927
94000,390,34500,8,1000992,1180471,179479
94000,449,34434,8,1022090,1371681,349591
94000,1125,34591,9,1107790,1248153,140363
94000,444,34359,7,1092854,1355139,262285
94000,342,34595,8,958875,1478382,519507
94000,590,34620,8,1172292,1390174,217882
94000,565,34630,7,1142370,1505591,363221
94000,195,34461,7,998200,1323914,325714
94000,264,34516,9,1050402,1236196,185794
94000,474,34474,8,1058957,1228766,169809
94000,252,34659,8,1072217,1477881,405664
94000,107,34646,8,1230880,1245361,14481
94000,704,34511,7,1075465,1229043,153578
94000,364,34727,8,1127117,1367480,240363
94000,480,34598,8,1447901,1497393,49492
94000,490,34515,8,1060282,1455848,395566
94000,590,34798,8,1296795,1338198,41403
94000,236,34676,8,950889,1331476,380587
94000,454,34605,8,1249819,1376929,127110
94000,518,34527,8,1249549,1436128,186579
94000,594,34383,8,960136,1755064,794928
94000,285,34568,8,971349,1357705,386356
94000,835,34524,7,1174691,1279014,104323
95000,454,34865,8,1058408,1278676,220268
95000,97,34892,8,1045687,1326722,281035
95000,350,34895,8,1244694,1353024,108330
95000,233,34960,7,1187879,1507447,319568
95000,625,34763,7,1002219,1396684,394465
95000,117,34944,8,1038703,1340783,302080
95000,462,34907,8,1010665,1316377,305712
95000,577,35015,9,1488812,1722129,233317
95000,860,34971,7,1032567,1641301,608734
95000,252,34901,9,1177562,1501488,323926
95000,516,34960,7,1034473,1222024,187551
95000,345,34798,8,1415372,1464768,49396
95000,116,34936,7,1181449,1669409,487960
95000,240,34881,8,1084977,1275673,190696
95000,861,35153,8,1271316,1437303,165987
95000,501,34890,7,1254455,1482709,228254
95000,169,34973,7,1157566,1341305,183739
95000,627,35091,8,1170109,1473945,303836
95000,72,34914,8,1282509,1605688,323179
95000,236,34998,11,1163675,1366350,202675
95000,251,35158,8,1116841,1331779,214938
95000,531,35001,9,1196256,1204246,7990
95000,523,34941,7,1172910,1387713,214803
95000,297,34969,8,1316673,1525746,209073
95000,710,35209,8,1244569,1625578,381009
95000,542,34809,8,898837,1490265,591428
95000,339,34871,7,1277957,1329842,51885
95000,595,34965,8,1263176,1656638,393462
95000,680,34938,8,1205396,1305776,100380
95000,352,35023,8,1179532,1306397,126865
95000,460,34861,7,1155078,1509892,354814
95000,217,35009,7,1280593,1478647,198054
95000,277,35000,9,1275647,1345981,70334
95000,341,34997,8,1147402,1595301,447899
95000,706,35081,8,1086531,1390593,304062
95000,315,34747,8,1019896,1385822,365926
95000,754,34770,8,1059105,1542845,483740
95000,138,34934,8,1133665,1497770,364105
95000,366,34939,7,966395,1377203,410808
95000,612,34977,7,1157112,1369155,212043
95000,1021,34883,7,985225,1403017,417792
95000,373,34838,8,1195136,1336468,141332
95000,491,34954,8,1074825,1370964,296139
95000,32,34996,8,1049243,1473120,423877
95000,454,34965,8,1117309,1275935,158626
95000,101,34954,7,1061374,1486628,425254
95000,318,34754,7,1258868,1398403,139535
95000,190,34909,9,1577569,1833863,256294
95000,160,34960,8,1538464,1575450,36986
95000,334,34988,8,1185415,1392883,207468
96000,166,35412,7,1518355,1555170,36815
96000,612,35026,7,1124789,1352771,227982
96000,249,35282,9,1042672,1272652,229980
96000,528,35413,8,1252760,1350356,97596
96000,404,35284,7,1190092,1626242,436150
96000,96,35448,7,1134252,1299132,164880
96000,307,35250,8,1321478,1439734,118256
96000,769,35191,9,1263965,1399494,135529
96000,278,35301,8,1032881,1303187,270306
96000,437,35282,9,1375876,1416973,41097
96000,163,35269,8,1009562,1341140,331578
96000,207,35346,8,1171349,1461467,290118
96000,401,35358,8,1072376,1347481,275105
96000,333,35442,7,1144905,1415664,270759
96000,227,35459,8,1019345,1364011,344666
96000,189,35381,7,1140493,1346851,206358
96000,119,35393,8,1028686,1277022,248336
96000,328,35317,8,1118508,1290408,171900
96000,145,35295,8,1206012,1819020,613008
96000,369,35322,8,1148925,1306092,157167
96000,220,35310,8,1080921,1342099,261178
96000,665,35483,7,1629179,1644335,15156
96000,80,35235,7,1048665,1446631,397966
96000,244,35108,7,1199905,1631120,431215
96000,651,35429,8,1176031,1491988,315957
96000,577,35415,8,1036966,1595487,558521
96000,194,35368,8,1082973,1381512,298539
96000,492,35248,8,1040097,1199629,159532
96000,402,35377,8,1150485,1440688,290203
96000,8,35325,8,1116301,1412587,296286
96000,249,35174,9,1104510,1708324,603814
96000,292,35375,9,1432637,1810030,377393
96000,343,35354,7,1193650,1443889,250239
96000,176,35251,9,1393471,1465119,71648
96000,159,35289,8,1069679,1559548,489869
96000,563,35342,8,1112061,1332849,220788
96000,200,35399,8,1174799,1309694,134895
96000,306,35377,7,1189654,1449907,260253
96000,493,35376,9,1270994,1320880,49886
96000,262,35186,8,1034610,1667850,633240
96000,288,35285,7,1349339,2186554,837215
96000,269,35193,7,1039897,1413854,373957
96000,260,35396,8,1124645,1403622,278977
96000,132,35411,9,1050990,1380960,329970
96000,297,35180,8,1235047,1508211,273164
96000,388,35360,8,1258973,1287610,28637
96000,989,35275,8,1059303,1318779,259476
96000,531,35354,8,1215453,1562527,347074
96000,468,35225,8,1045122,1271309,226187
96000,366,35302,8,1733296,1823493,90197
97000,534,35657,8,1074763,1370074,295311
97000,221,35513,8,1158245,1391560,233315
97000,398,35661,8,994403,1461314,466911
97000,396,35751,8,1108000,1335561,227561
97000,482,35667,8,1301302,1449205,147903
97000,72,35626,8,1030683,1215138,184455
97000,631,35737,8,1077028,1375585,298557
97000,240,35689,8,1482302,1496699,14397
97000,187,35729,7,1068934,1378640,309706
97000,223,35792,8,1290751,1365331,74580
97000,165,35782,8,1451208,1589726,138518
97000,917,35637,9,1039890,1438039,398149
97000,371,35721,8,1072279,1340820,268541
97000,788,35800,8,1176159,1456050,279891
97000,202,35546,8,1204615,1387245,182630
97000,373,35670,9,1180501,1350847,170346
97000,259,35721,8,1129003,1274310,145307
97000,110,35565,7,1077275,1314799,237524
97000,275,35526,8,1116492,1639760,523268
97000,375,35696,8,1029950,1390781,360831
97000,643,35710,8,1302231,1569287,267056
97000,513,35620,7,1005649,1691087,685438
97000,554,35683,7,1088286,1317008,228722
97000,280,35602,8,1192430,1308066,115636
97000,121,35664,7,1065743,1453590,387847
97000,546,35758,8,1471798,1484418,12620
97000,894,35739,8,1371597,1530007,158410
97000,350,35625,8,1262488,1539513,277025
97000,208,35654,8,1364347,1389572,25225
97000,44,35809,7,1035674,1401922,366248
97000,296,35658,7,1040376,1334221,293845
97000,226,35787,8,1095139,1304065,208926
97000,287,35689,8,1036301,1356244,319943
97000,19,35818,8,1350601,1408298,57697
97000,865,35662,8,1019328,1377789,358461
97000,528,35620,8,1351003,1565241,214238
97000,430,35657,8,1192654,1370501,177847
97000,403,35672,8,1290789,1361598,70809
97000,502,35621,8,1153140,1400765,247625
97000,564,35466,8,1356613,1363429,6816
97000,378,35502,9,1093719,1236895,143176
97000,207,35715,8,1309380,1641343,331963
97000,503,35687,8,1075295,1313348,238053
97000,278,35697,8,1305650,1599718,294068
97000,182,35692,8,1375429,1465573,90144
97000,144,35678,8,1177167,1330852,153685
97000,538,35673,9,925773,1362448,436675
97000,198,35582,7,1267161,1419583,152422
97000,333,35772,8,1132673,1287985,155312
97000,270,35727,8,1403743,1492765,89022
98000,313,36105,8,1429131,1719179,290048
98000,184,36222,8,1200138,1387320,187182
98000,522,36148,8,991304,1421597,430293
98000,597,35978,9,1024708,1405335,380627
98000,754,36140,8,1402168,1467951,65783
98000,447,35987,7,1119891,1517861,397970
98000,180,36134,8,1031207,1395664,364457
98000,798,36111,8,1138554,1381030,242476
98000,564,36157,8,1128499,1504874,376375
98000,223,36101,7,1253263,1346285,93022
98000,258,36138,8,1180541,1526013,345472
98000,362,36012,8,1166575,1535493,368918
98000,461,35915,7,1070631,1565284,494653
98000,315,36068,8,1122429,1715817,593388
98000,251,35937,8,1210690,1680897,470207
98000,798,36181,8,1274727,1776687,501960
98000,344,35975,8,1119858,1373741,253883
98000,131,36002,8,1053188,1485201,432013
98000,497,36039,8,1043660,1483507,439847
98000,270,35961,7,1450339,1541813,91474
98000,155,35999,8,1126152,1582254,456102
98000,674,36002,7,1302640,1358978,56338
98000,499,36030,8,1355277,1573330,218053
98000,363,36077,7,1251403,1436681,185278
98000,709,36130,7,1176839,1606921,430082
98000,145,36136,8,1030386,1315825,285439
98000,267,35985,7,1128855,1340807,211952
98000,512,36108,7,1251849,1607931,356082
98000,411,36030,9,1299904,1908909,609005
98000,552,36141,8,1083209,1371329,288120
98000,493,36044,8,1253999,1281948,27949
98000,471,36183,7,1202591,1388069,185478
98000,429,36189,8,1226320,1275870,49550
98000,321,36076,8,1329265,1951510,622245
98000,388,36016,8,1248292,1762767,514475
98000,229,36145,8,1239118,1458430,219312
98000,358,36020,8,1078983,1254476,175493
98000,551,36103,8,1123168,1287024,163856
98000,358,35934,8,1460102,1803244,343142
98000,345,36036,8,1180531,1443509,262978
98000,165,35916,7,1174842,1342023,167181
98000,404,35883,7,1117162,1476272,359110
98000,467,35815,8,1182904,1349436,166532
98000,930,36011,8,1132843,1581972,449129
98000,140,36006,7,1206524,1318433,111909
98000,672,36216,7,1199767,1415769,216002
98000,396,36198,8,1059166,1396717,337551
98000,369,36217,7,1263113,1322206,59093
98000,148,36145,8,1076309,1288996,212687
98000,887,36039,7,1317763,1367356,49593
99000,543,36574,8,1127616,1384603,256987
99000,594,36299,7,1292992,1394218,101226
99000,70,36438,8,1171300,1487530,316230
99000,850,36474,8,1183072,1252393,69321
99000,99,36565,8,1160877,1774855,613978
99000,661,36440,7,1249080,1438654,189574
99000,587,36427,8,1118902,1470324,351422
99000,261,36338,7,1247574,1569978,322404
99000,299,36424,8,1110313,1536344,426031
99000,375,36382,7,1062276,1407591,345315
99000,328,36349,7,1384413,1509741,125328
99000,238,36573,9,1376497,1460547,84050
99000,462,36369,8,1124983,1395045,270062
99000,170,36492,8,1098254,1586538,488284
99000,273,36333,8,1034477,1262914,228437
99000,457,36572,8,1122077,1354850,232773
99000,247,36452,9,1254455,1315078,60623
99000,889,36456,8,1243069,1384310,141241
99000,569,36440,8,1052609,1370918,318309
99000,183,36439,9,1074757,1454894,380137
99000,467,36289,8,1079580,1523542,443962
99000,413,36415,8,1169798,1306723,136925
99000,616,36408,7,1034991,1344631,309640
99000,348,36289,8,1101690,1322820,221130
99000,370,36359,8,998647,1345532,346885
99000,284,36466,8,1075852,1338456,262604
99000,447,36334,9,1072659,1461646,388987
99000,565,36335,9,1316787,1402627,85840
99000,860,36611,8,1250260,1351877,101617
99000,645,36502,7,1451018,1500311,49293
99000,180,36322,8,1092565,1495946,403381
99000,671,36376,8,1081036,1535538,454502
99000,222,36234,8,1153158,1506099,352941
99000,714,36452,9,1107327,2017113,909786
99000,455,36518,8,1212115,1549863,337748
99000,235,36519,8,1004703,1576412,571709
99000,318,36344,8,1114241,1346783,232542
99000,90,36349,8,1173616,1427825,254209
99000,309,36366,7,1312726,1472183,159457
99000,250,36253,9,1282630,1366209,83579
99000,251,36317,7,1157302,1374596,217294
99000,276,36319,7,1047839,1477896,430057
99000,588,36269,8,1129122,1432847,303725
99000,615,36371,8,1252752,1353582,100830
99000,196,36437,7,1528832,1699240,170408
99000,446,36445,7,1098289,1309076,210787
99000,451,36368,7,1141666,1480372,338706
99000,175,36402,8,1108063,1337121,229058
99000,133,36480,8,1152219,1411837,259618
99000,777,36245,8,1070207,1366808,296601
100000,104,36910,7,1091313,1721460,630147
100000,743,36713,8,1338278,1572703,234425
100000,596,36861,8,1128462,1429850,301388
100000,386,36895,7,1232339,1817149,584810
100000,527,36818,7,1051303,1252388,201085
100000,104,36862,8,1021980,1413605,391625
100000,528,36836,7,1107154,1360361,253207
100000,405,36672,7,1187173,1442878,255705
100000,321,36641,7,1024216,1238146,213930
100000,647,36781,7,1260127,1370645,110518
100000,457,36828,7,1338316,1432755,94439
100000,518,36549,8,1409878,1892216,482338
100000,917,36791,7,1171151,1513199,342048
100000,437,36872,9,1098622,1495502,396880
100000,650,36771,7,1205648,1874738,669090
100000,173,36682,8,1143463,1549032,405569
100000,318,36945,11,1366500,1646274,279774
100000,161,36739,8,1574239,1574617,378
100000,210,36905,8,1356263,1557622,201359
100000,493,36737,7,982714,1386996,404282
100000,315,36769,9,1049104,1365283,316179
100000,432,36717,8,1362550,1387244,24694
100000,378,36620,7,1077271,1502426,425155
100000,118,36871,7,1066013,1303379,237366
100000,386,36622,7,1045309,1337229,291920
100000,308,36848,8,1438319,1710943,272624
100000,258,36620,7,1181726,1431627,249901
100000,569,36991,8,1277628,1850690,573062
100000,669,36636,8,1070509,1353497,282988
100000,535,36749,7,1171375,1485869,314494
100000,671,36950,8,1161526,1488477,326951
100000,854,36816,10,1336172,1419156,82984
100000,318,36750,8,1162354,1380218,217864
100000,314,36944,7,1240131,1437097,196966
100000,478,36928,8,1133184,1523125,389941
100000,500,36694,7,1591471,1777444,185973
100000,586,36681,8,1096710,1653124,556414
100000,558,36825,8,1263907,1543888,279981
100000,780,36519,8,1048256,1448186,399930
100000,463,36769,8,1139228,1521882,382654
100000,664,36722,8,1177573,1465958,288385
100000,459,36728,7,1201176,1796659,595483
100000,144,36785,7,1134111,1427910,293799
100000,339,36602,7,1178615,1547903,369288
100000,996,36833,8,1247285,1325611,78326
100000,359,36754,8,1138961,1617056,478095
100000,342,36752,7,1248187,1420086,171899
100000,223,36813,7,1081421,1430941,349520
100000,323,36860,8,1209016,1612089,403073
100000,398,36777,8,978989,1320447,341458
